time(sec),sum-all,sum-rcv,sum-trans,rcv-bytes,rcv-packets,rcv-errs,rcv-drop,rcv-fifo,rcv-frame,rcv-compressed,rcv-multicast,trans-bytes,trans-packets,trans-errs,trans-drop,trans-fifo,trans-colls,trans-carrier,trans-compressed
0.000,0,0,0,0,0,0,0,0,0,0,0,0,0,0,0,0,0,0,0
1.007,55,55,0,54,1,0,0,0,0,0,0,0,0,0,0,0,0,0,0
2.014,4020,440,3580,432,8,0,0,0,0,0,0,3568,12,0,0,0,0,0,0
3.021,5635,641,4994,630,11,0,0,0,0,0,0,4976,18,0,0,0,0,0,0
4.028,8520,751,7769,738,13,0,0,0,0,0,0,7746,23,0,0,0,0,0,0
5.035,8520,751,7769,738,13,0,0,0,0,0,0,7746,23,0,0,0,0,0,0
6.042,8520,751,7769,738,13,0,0,0,0,0,0,7746,23,0,0,0,0,0,0
7.049,8520,751,7769,738,13,0,0,0,0,0,0,7746,23,0,0,0,0,0,0
8.056,8520,751,7769,738,13,0,0,0,0,0,0,7746,23,0,0,0,0,0,0
9.063,8520,751,7769,738,13,0,0,0,0,0,0,7746,23,0,0,0,0,0,0
10.070,8520,751,7769,738,13,0,0,0,0,0,0,7746,23,0,0,0,0,0,0
11.076,8520,751,7769,738,13,0,0,0,0,0,0,7746,23,0,0,0,0,0,0
12.082,8520,751,7769,738,13,0,0,0,0,0,0,7746,23,0,0,0,0,0,0
13.089,8520,751,7769,738,13,0,0,0,0,0,0,7746,23,0,0,0,0,0,0
14.096,8606,794,7812,780,14,0,0,0,0,0,0,7788,24,0,0,0,0,0,0
15.103,8606,794,7812,780,14,0,0,0,0,0,0,7788,24,0,0,0,0,0,0
16.110,8606,794,7812,780,14,0,0,0,0,0,0,7788,24,0,0,0,0,0,0
17.116,8692,837,7855,822,15,0,0,0,0,0,0,7830,25,0,0,0,0,0,0
18.122,8692,837,7855,822,15,0,0,0,0,0,0,7830,25,0,0,0,0,0,0
19.129,8692,837,7855,822,15,0,0,0,0,0,0,7830,25,0,0,0,0,0,0
20.136,93831,80863,12968,80818,45,0,0,0,0,0,0,12914,54,0,0,0,0,0,0
21.143,42716148,42654076,62072,42649248,4828,0,0,0,0,0,0,61691,381,0,0,0,0,0,0
22.150,42716148,42654076,62072,42649248,4828,0,0,0,0,0,0,61691,381,0,0,0,0,0,0
23.158,42716148,42654076,62072,42649248,4828,0,0,0,0,0,0,61691,381,0,0,0,0,0,0
24.165,42897760,42736310,161450,42731417,4893,0,0,0,0,0,0,160986,464,0,0,0,0,0,0
25.172,42897760,42736310,161450,42731417,4893,0,0,0,0,0,0,160986,464,0,0,0,0,0,0
26.179,42897760,42736310,161450,42731417,4893,0,0,0,0,0,0,160986,464,0,0,0,0,0,0
27.186,85559722,42767202,42792520,42762221,4981,0,0,0,0,0,0,42787309,5211,0,0,0,0,0,0
28.193,85608403,42769360,42839043,42764348,5012,0,0,0,0,0,0,42833745,5298,0,0,0,0,0,0
29.200,85608403,42769360,42839043,42764348,5012,0,0,0,0,0,0,42833745,5298,0,0,0,0,0,0
30.207,231183129,145811489,85371640,145794956,16533,0,0,0,0,0,0,85361316,10324,0,0,0,0,0,0
31.214,232346006,146259623,86086383,146242922,16701,0,0,0,0,0,0,86075896,10487,0,0,0,0,0,0
32.221,232352257,146261456,86090801,146244737,16719,0,0,0,0,0,0,86080289,10512,0,0,0,0,0,0
33.229,232352257,146261456,86090801,146244737,16719,0,0,0,0,0,0,86080289,10512,0,0,0,0,0,0
34.236,232352257,146261456,86090801,146244737,16719,0,0,0,0,0,0,86080289,10512,0,0,0,0,0,0
35.243,232352257,146261456,86090801,146244737,16719,0,0,0,0,0,0,86080289,10512,0,0,0,0,0,0
36.250,232352257,146261456,86090801,146244737,16719,0,0,0,0,0,0,86080289,10512,0,0,0,0,0,0
37.257,232569141,146477769,86091372,146461023,16746,0,0,0,0,0,0,86080853,10519,0,0,0,0,0,0
38.265,232879090,146524370,86354720,146507559,16811,0,0,0,0,0,0,86344124,10596,0,0,0,0,0,0
39.272,232879224,146524370,86354854,146507559,16811,0,0,0,0,0,0,86344256,10598,0,0,0,0,0,0
40.279,232879224,146524370,86354854,146507559,16811,0,0,0,0,0,0,86344256,10598,0,0,0,0,0,0
41.286,232879224,146524370,86354854,146507559,16811,0,0,0,0,0,0,86344256,10598,0,0,0,0,0,0
42.294,437370944,248778187,188592757,248749161,29026,0,0,0,0,0,0,188570189,22568,0,0,0,0,0,0
43.302,645427283,352819088,292608195,352777510,41578,0,0,0,0,0,0,292573457,34738,0,0,0,0,0,0
44.309,1264092164,662179836,601912328,662101672,78164,0,0,0,0,0,0,601841846,70482,0,0,0,0,0,0
45.317,1676668878,868489369,808179509,868386844,102525,0,0,0,0,0,0,808085261,94248,0,0,0,0,0,0
46.324,2089153300,1074742525,1014410775,1074615850,126675,0,0,0,0,0,0,1014292686,118089,0,0,0,0,0,0
47.333,2656158052,1352983751,1303174301,1352824144,159607,0,0,0,0,0,0,1303022531,151770,0,0,0,0,0,0
48.340,3120424990,1590407170,1530017820,1590219648,187522,0,0,0,0,0,0,1529839700,178120,0,0,0,0,0,0
49.347,3532908487,1796676128,1736232359,1796464221,211907,0,0,0,0,0,0,1736030646,201713,0,0,0,0,0,0
50.354,3945438928,2002959878,1942479050,2002723361,236517,0,0,0,0,0,0,1942253271,225779,0,0,0,0,0,0
51.361,4564135928,2312330328,2251805600,2312057104,273224,0,0,0,0,0,0,2251543748,261852,0,0,0,0,0,0
52.368,4976721308,2518628557,2458092751,2518331130,297427,0,0,0,0,0,0,2457806835,285916,0,0,0,0,0,0
53.375,5389235823,2724899892,2664335931,2724578045,321847,0,0,0,0,0,0,2664025993,309938,0,0,0,0,0,0
54.384,5899592831,2978365340,2921227491,2978013416,351924,0,0,0,0,0,0,2920887697,339794,0,0,0,0,0,0
55.390,6420559620,3240617195,3179942425,3240233726,383469,0,0,0,0,0,0,3179572614,369811,0,0,0,0,0,0
56.399,6833087042,3446902811,3386184231,3446494700,408111,0,0,0,0,0,0,3385790422,393809,0,0,0,0,0,0
57.406,7245595460,3653176113,3592419347,3652743543,432570,0,0,0,0,0,0,3592001645,417702,0,0,0,0,0,0
58.414,7848309304,3946568644,3901740660,3946101348,467296,0,0,0,0,0,0,3901286956,453704,0,0,0,0,0,0
59.421,8276912946,4168855488,4108057458,4168361843,493645,0,0,0,0,0,0,4107579653,477805,0,0,0,0,0,0
60.428,8689439420,4375128333,4314311087,4374610244,518089,0,0,0,0,0,0,4313809108,501979,0,0,0,0,0,0
61.437,9194610877,4625393730,4569217147,4624846130,547600,0,0,0,0,0,0,4568685534,531613,0,0,0,0,0,0
62.445,9720714433,4890801764,4829912669,4890222683,579081,0,0,0,0,0,0,4829350718,561951,0,0,0,0,0,0
63.452,10133227702,5097080134,5036147568,5096476527,603607,0,0,0,0,0,0,5035561726,585842,0,0,0,0,0,0
64.460,10545719807,5303339632,5242380175,5302711770,627862,0,0,0,0,0,0,5241770466,609709,0,0,0,0,0,0
65.467,11161280948,5609589821,5551691127,5608925900,663921,0,0,0,0,0,0,5551045479,645648,0,0,0,0,0,0
66.475,11577021541,5819013913,5758007628,5818325062,688851,0,0,0,0,0,0,5757337578,670050,0,0,0,0,0,0
67.483,11989533404,6025287057,5964246347,6024573762,713295,0,0,0,0,0,0,5963552335,694012,0,0,0,0,0,0
68.493,12545074049,6299034009,6246040040,6298288499,745510,0,0,0,0,0,0,6245313145,726895,0,0,0,0,0,0
69.500,13020793174,6540939301,6479853873,6540165327,773974,0,0,0,0,0,0,6479099800,754073,0,0,0,0,0,0
70.508,13433294752,6747204077,6686090675,6746405774,798303,0,0,0,0,0,0,6685312681,777994,0,0,0,0,0,0
71.517,13856882875,6957970475,6898912400,6957147324,823151,0,0,0,0,0,0,6898109567,802833,0,0,0,0,0,0
72.525,14464585079,7262878984,7201706095,7262019668,859316,0,0,0,0,0,0,7200867929,838166,0,0,0,0,0,0
73.532,14877066514,7469136841,7407929673,7468253299,883542,0,0,0,0,0,0,7407067775,861898,0,0,0,0,0,0
74.539,15289584513,7675413467,7614171046,7674505417,908050,0,0,0,0,0,0,7613285145,885901,0,0,0,0,0,0
75.547,15908280707,7984794630,7923486077,7983849689,944941,0,0,0,0,0,0,7922564269,921808,0,0,0,0,0,0
76.554,16320886615,8191097027,8129789588,8190127828,969199,0,0,0,0,0,0,8128843478,946110,0,0,0,0,0,0
77.562,16733417050,8397367692,8336049358,8396374090,993602,0,0,0,0,0,0,8335079387,969971,0,0,0,0,0,0
78.572,17251532500,8653946719,8597585781,8652922909,1023810,0,0,0,0,0,0,8596585391,1000390,0,0,0,0,0,0
79.579,17764675347,8913026704,8851648643,8911972331,1054373,0,0,0,0,0,0,8850618751,1029892,0,0,0,0,0,0
80.586,18177178985,9119297825,9057881160,9118219028,1078797,0,0,0,0,0,0,9056827408,1053752,0,0,0,0,0,0
81.594,18589679788,9325562588,9264117200,9324459467,1103121,0,0,0,0,0,0,9263039531,1077669,0,0,0,0,0,0
82.602,19188623571,9615206097,9573417474,9614068383,1137714,0,0,0,0,0,0,9572304021,1113453,0,0,0,0,0,0
83.609,19620954134,9841251687,9779702447,9840087331,1164356,0,0,0,0,0,0,9778565068,1137379,0,0,0,0,0,0
84.617,20033471461,10047511782,9985959679,10046323175,1188607,0,0,0,0,0,0,9984798073,1161606,0,0,0,0,0,0
85.623,20445988963,10253793439,10192195524,10252580254,1213185,0,0,0,0,0,0,10191010002,1185522,0,0,0,0,0,0
86.631,21064644027,10563145231,10501498796,10561895614,1249617,0,0,0,0,0,0,10500277534,1221262,0,0,0,0,0,0
87.638,21477233126,10769456431,10707776695,10768182441,1273990,0,0,0,0,0,0,10706531516,1245179,0,0,0,0,0,0
88.646,21889746657,10975736092,10914010565,10974437553,1298539,0,0,0,0,0,0,10912741500,1269065,0,0,0,0,0,0
89.655,22424944716,11238502463,11186442253,11237172763,1329700,0,0,0,0,0,0,11185141547,1300706,0,0,0,0,0,0
90.663,22921023339,11491416560,11429606779,11490056926,1359634,0,0,0,0,0,0,11428277972,1328807,0,0,0,0,0,0
91.671,23333529148,11697678814,11635850334,11696294887,1383927,0,0,0,0,0,0,11634497504,1352830,0,0,0,0,0,0
92.680,23783273216,11919963201,11863310015,11918552854,1410347,0,0,0,0,0,0,11861930733,1379282,0,0,0,0,0,0
93.687,24364823752,12213368257,12151455495,12211923098,1445159,0,0,0,0,0,0,12150042663,1412832,0,0,0,0,0,0
94.694,24777344352,12419658018,12357686334,12418188154,1469864,0,0,0,0,0,0,12356249685,1436649,0,0,0,0,0,0
95.702,25189856831,12625936580,12563920251,12624442179,1494401,0,0,0,0,0,0,12562459719,1460532,0,0,0,0,0,0
96.710,25770804970,12904441474,12866363496,12902914006,1527468,0,0,0,0,0,0,12864867829,1495667,0,0,0,0,0,0
97.718,26221159981,13141646272,13079513709,13140090342,1555930,0,0,0,0,0,0,13077993334,1520375,0,0,0,0,0,0
98.725,26633663300,13347915265,13285748035,13346334952,1580313,0,0,0,0,0,0,13284203773,1544262,0,0,0,0,0,0
99.733,27050676341,13557366618,13493309723,13555761315,1605303,0,0,0,0,0,0,13491741516,1568207,0,0,0,0,0,0
100.741,27664917658,13863605433,13801312225,13861963886,1641547,0,0,0,0,0,0,13799708548,1603677,0,0,0,0,0,0
101.749,28077419686,14069873118,14007546568,14068207199,1665919,0,0,0,0,0,0,14005918999,1627569,0,0,0,0,0,0
102.757,28489914372,14276145059,14213769313,14274454714,1690345,0,0,0,0,0,0,14212118031,1651282,0,0,0,0,0,0
103.766,29011651898,14536847102,14474804796,14535125749,1721353,0,0,0,0,0,0,14473123317,1681479,0,0,0,0,0,0
104.773,29521192991,14791840665,14729352326,14790089016,1751649,0,0,0,0,0,0,14727641356,1710970,0,0,0,0,0,0
105.780,29933703441,14998115334,14935588107,14996339215,1776119,0,0,0,0,0,0,14933853222,1734885,0,0,0,0,0,0
106.788,30346190328,15204379567,15141810761,15202579126,1800441,0,0,0,0,0,0,15140052155,1758606,0,0,0,0,0,0
107.795,30964182817,15513069914,15451112903,15511233061,1836853,0,0,0,0,0,0,15449318559,1794344,0,0,0,0,0,0
108.802,31377449921,15720058424,15657391497,15718196900,1861524,0,0,0,0,0,0,15655573243,1818254,0,0,0,0,0,0
109.810,31789946805,15926318957,15863627848,15924433163,1885794,0,0,0,0,0,0,15861785667,1842181,0,0,0,0,0,0
110.819,32274262726,16166830488,16107432238,16164916099,1914389,0,0,0,0,0,0,16105561909,1870329,0,0,0,0,0,0
111.826,32821240274,16442005216,16379235058,16440058239,1946977,0,0,0,0,0,0,16377333097,1901961,0,0,0,0,0,0
112.834,33233754888,16648285039,16585469849,16646313505,1971534,0,0,0,0,0,0,16583544001,1925848,0,0,0,0,0,0
113.841,33646257215,16854553498,16791703717,16852557582,1995916,0,0,0,0,0,0,16789753987,1949730,0,0,0,0,0,0
114.850,34245373156,17145411281,17099961875,17143381112,2030169,0,0,0,0,0,0,17097976564,1985311,0,0,0,0,0,0
115.856,34677503087,17370213574,17307289513,17368156875,2056699,0,0,0,0,0,0,17305280073,2009440,0,0,0,0,0,0
116.863,35090001186,17576477687,17513523499,17574396672,2081015,0,0,0,0,0,0,17511490181,2033318,0,0,0,0,0,0
117.871,35529182584,17795961182,17733221402,17793854241,2106941,0,0,0,0,0,0,17731162685,2058717,0,0,0,0,0,0
118.878,36121287219,18092158631,18029128588,18090016507,2142124,0,0,0,0,0,0,18027035279,2093309,0,0,0,0,0,0
119.886,36533791944,18298423409,18235368535,18296256960,2166449,0,0,0,0,0,0,18233251253,2117282,0,0,0,0,0,0
120.893,36946298814,18504701151,18441597663,18502510185,2190966,0,0,0,0,0,0,18439456571,2141092,0,0,0,0,0,0
121.900,37546628990,18795726361,18750902629,18793500775,2225586,0,0,0,0,0,0,18748725636,2176993,0,0,0,0,0,0
122.908,37977581610,19020391167,18957190443,19018138974,2252193,0,0,0,0,0,0,18954989532,2200911,0,0,0,0,0,0
123.914,38390088289,19226664238,19163424051,19224387595,2276643,0,0,0,0,0,0,19161199272,2224779,0,0,0,0,0,0
124.920,38802590635,19432942437,19369648198,19430641272,2301165,0,0,0,0,0,0,19367399685,2248513,0,0,0,0,0,0
125.928,39421337740,19742342192,19678995548,19740004524,2337668,0,0,0,0,0,0,19676711277,2284271,0,0,0,0,0,0
126.934,39833853207,19948630410,19885222797,19946268074,2362336,0,0,0,0,0,0,19882914750,2308047,0,0,0,0,0,0
127.941,40246358552,20154895763,20091462789,20152509088,2386675,0,0,0,0,0,0,20089130790,2331999,0,0,0,0,0,0
128.951,40770008978,20414183706,20355825272,20411766359,2417347,0,0,0,0,0,0,20353462612,2362660,0,0,0,0,0,0
129.958,41277643571,20670562570,20607081001,20668115004,2447566,0,0,0,0,0,0,20604689090,2391911,0,0,0,0,0,0
130.965,41690144314,20876813155,20813331159,20874341473,2471682,0,0,0,0,0,0,20810915142,2416017,0,0,0,0,0,0
131.973,42102664473,21083095253,21019569220,21080598980,2496273,0,0,0,0,0,0,21017129388,2439832,0,0,0,0,0,0
132.981,42721405377,21392501342,21328904035,21389968451,2532891,0,0,0,0,0,0,21326428498,2475537,0,0,0,0,0,0
133.988,43133902739,21598767304,21535135435,21596210061,2557243,0,0,0,0,0,0,21532636061,2499374,0,0,0,0,0,0
134.996,43546315759,21804980882,21741334877,21802399449,2581433,0,0,0,0,0,0,21738811533,2523344,0,0,0,0,0,0
