time(sec),sum-all,sum-rcv,sum-trans,rcv-bytes,rcv-packets,rcv-errs,rcv-drop,rcv-fifo,rcv-frame,rcv-compressed,rcv-multicast,trans-bytes,trans-packets,trans-errs,trans-drop,trans-fifo,trans-colls,trans-carrier,trans-compressed
0.000,0,0,0,0,0,0,0,0,0,0,0,0,0,0,0,0,0,0,0
1.009,636,110,526,108,2,0,0,0,0,0,0,524,2,0,0,0,0,0,0
2.017,2098,275,1823,270,5,0,0,0,0,0,0,1818,5,0,0,0,0,0,0
3.025,4862,440,4422,432,8,0,0,0,0,0,0,4412,10,0,0,0,0,0,0
4.033,6987,677,6310,666,11,0,0,0,0,0,0,6296,14,0,0,0,0,0,0
5.041,6987,677,6310,666,11,0,0,0,0,0,0,6296,14,0,0,0,0,0,0
6.050,6987,677,6310,666,11,0,0,0,0,0,0,6296,14,0,0,0,0,0,0
7.058,6987,677,6310,666,11,0,0,0,0,0,0,6296,14,0,0,0,0,0,0
8.066,6987,677,6310,666,11,0,0,0,0,0,0,6296,14,0,0,0,0,0,0
9.074,6987,677,6310,666,11,0,0,0,0,0,0,6296,14,0,0,0,0,0,0
10.082,6987,677,6310,666,11,0,0,0,0,0,0,6296,14,0,0,0,0,0,0
11.090,129003,95545,33458,95487,58,0,0,0,0,0,0,33409,49,0,0,0,0,0,0
12.099,221410,99391,122019,99301,90,0,0,0,0,0,0,121929,90,0,0,0,0,0,0
13.107,42841336,141082,42700254,140778,304,0,0,0,0,0,0,42695320,4934,0,0,0,0,0,0
14.115,85443375,42655168,42788207,42650104,5064,0,0,0,0,0,0,42783053,5154,0,0,0,0,0,0
15.123,85443375,42655168,42788207,42650104,5064,0,0,0,0,0,0,42783053,5154,0,0,0,0,0,0
16.131,85443375,42655168,42788207,42650104,5064,0,0,0,0,0,0,42783053,5154,0,0,0,0,0,0
17.139,85443375,42655168,42788207,42650104,5064,0,0,0,0,0,0,42783053,5154,0,0,0,0,0,0
18.147,85443375,42655168,42788207,42650104,5064,0,0,0,0,0,0,42783053,5154,0,0,0,0,0,0
19.156,85445452,42655314,42790138,42650248,5066,0,0,0,0,0,0,42784979,5159,0,0,0,0,0,0
20.164,85445452,42655314,42790138,42650248,5066,0,0,0,0,0,0,42784979,5159,0,0,0,0,0,0
21.172,85445452,42655314,42790138,42650248,5066,0,0,0,0,0,0,42784979,5159,0,0,0,0,0,0
22.181,85445452,42655314,42790138,42650248,5066,0,0,0,0,0,0,42784979,5159,0,0,0,0,0,0
23.189,85445452,42655314,42790138,42650248,5066,0,0,0,0,0,0,42784979,5159,0,0,0,0,0,0
24.197,85445452,42655314,42790138,42650248,5066,0,0,0,0,0,0,42784979,5159,0,0,0,0,0,0
25.205,85445452,42655314,42790138,42650248,5066,0,0,0,0,0,0,42784979,5159,0,0,0,0,0,0
26.213,85445452,42655314,42790138,42650248,5066,0,0,0,0,0,0,42784979,5159,0,0,0,0,0,0
27.221,85445452,42655314,42790138,42650248,5066,0,0,0,0,0,0,42784979,5159,0,0,0,0,0,0
28.230,85445452,42655314,42790138,42650248,5066,0,0,0,0,0,0,42784979,5159,0,0,0,0,0,0
29.238,85445452,42655314,42790138,42650248,5066,0,0,0,0,0,0,42784979,5159,0,0,0,0,0,0
30.246,85445452,42655314,42790138,42650248,5066,0,0,0,0,0,0,42784979,5159,0,0,0,0,0,0
31.254,85445538,42655357,42790181,42650290,5067,0,0,0,0,0,0,42785021,5160,0,0,0,0,0,0
32.262,85445538,42655357,42790181,42650290,5067,0,0,0,0,0,0,42785021,5160,0,0,0,0,0,0
33.271,85452792,42656288,42796504,42651208,5080,0,0,0,0,0,0,42791327,5177,0,0,0,0,0,0
34.279,85455866,42656544,42799322,42651460,5084,0,0,0,0,0,0,42794139,5183,0,0,0,0,0,0
35.287,85455866,42656544,42799322,42651460,5084,0,0,0,0,0,0,42794139,5183,0,0,0,0,0,0
36.295,85455866,42656544,42799322,42651460,5084,0,0,0,0,0,0,42794139,5183,0,0,0,0,0,0
37.303,85455866,42656544,42799322,42651460,5084,0,0,0,0,0,0,42794139,5183,0,0,0,0,0,0
38.311,85455866,42656544,42799322,42651460,5084,0,0,0,0,0,0,42794139,5183,0,0,0,0,0,0
39.319,85455866,42656544,42799322,42651460,5084,0,0,0,0,0,0,42794139,5183,0,0,0,0,0,0
40.327,85455866,42656544,42799322,42651460,5084,0,0,0,0,0,0,42794139,5183,0,0,0,0,0,0
41.336,85455866,42656544,42799322,42651460,5084,0,0,0,0,0,0,42794139,5183,0,0,0,0,0,0
42.344,85578210,42750629,42827581,42745499,5130,0,0,0,0,0,0,42822338,5243,0,0,0,0,0,0
43.353,231333208,85452801,145880407,85442473,10328,0,0,0,0,0,0,145863515,16892,0,0,0,0,0,0
44.361,231825619,85717357,146108262,85706823,10534,0,0,0,0,0,0,146090993,17269,0,0,0,0,0,0
45.369,231825619,85717357,146108262,85706823,10534,0,0,0,0,0,0,146090993,17269,0,0,0,0,0,0
46.377,231825705,85717400,146108305,85706865,10535,0,0,0,0,0,0,146091035,17270,0,0,0,0,0,0
47.386,231825705,85717400,146108305,85706865,10535,0,0,0,0,0,0,146091035,17270,0,0,0,0,0,0
48.394,232047235,85717850,146329385,85707310,10540,0,0,0,0,0,0,146312087,17298,0,0,0,0,0,0
49.402,232047235,85717850,146329385,85707310,10540,0,0,0,0,0,0,146312087,17298,0,0,0,0,0,0
50.410,232047235,85717850,146329385,85707310,10540,0,0,0,0,0,0,146312087,17298,0,0,0,0,0,0
51.418,232047235,85717850,146329385,85707310,10540,0,0,0,0,0,0,146312087,17298,0,0,0,0,0,0
52.426,232047235,85717850,146329385,85707310,10540,0,0,0,0,0,0,146312087,17298,0,0,0,0,0,0
53.435,232047235,85717850,146329385,85707310,10540,0,0,0,0,0,0,146312087,17298,0,0,0,0,0,0
54.443,232047235,85717850,146329385,85707310,10540,0,0,0,0,0,0,146312087,17298,0,0,0,0,0,0
55.451,232269692,85939845,146329847,85929278,10567,0,0,0,0,0,0,146312543,17304,0,0,0,0,0,0
56.459,232377805,85992849,146384956,85982127,10722,0,0,0,0,0,0,146367490,17466,0,0,0,0,0,0
57.467,232377805,85992849,146384956,85982127,10722,0,0,0,0,0,0,146367490,17466,0,0,0,0,0,0
58.475,232377805,85992849,146384956,85982127,10722,0,0,0,0,0,0,146367490,17466,0,0,0,0,0,0
59.483,232377805,85992849,146384956,85982127,10722,0,0,0,0,0,0,146367490,17466,0,0,0,0,0,0
60.491,232377805,85992849,146384956,85982127,10722,0,0,0,0,0,0,146367490,17466,0,0,0,0,0,0
61.499,232377805,85992849,146384956,85982127,10722,0,0,0,0,0,0,146367490,17466,0,0,0,0,0,0
62.507,232377805,85992849,146384956,85982127,10722,0,0,0,0,0,0,146367490,17466,0,0,0,0,0,0
63.516,232377805,85992849,146384956,85982127,10722,0,0,0,0,0,0,146367490,17466,0,0,0,0,0,0
64.524,232377805,85992849,146384956,85982127,10722,0,0,0,0,0,0,146367490,17466,0,0,0,0,0,0
65.532,232377805,85992849,146384956,85982127,10722,0,0,0,0,0,0,146367490,17466,0,0,0,0,0,0
66.540,232377805,85992849,146384956,85982127,10722,0,0,0,0,0,0,146367490,17466,0,0,0,0,0,0
67.548,232377805,85992849,146384956,85982127,10722,0,0,0,0,0,0,146367490,17466,0,0,0,0,0,0
68.557,232377805,85992849,146384956,85982127,10722,0,0,0,0,0,0,146367490,17466,0,0,0,0,0,0
69.565,232377805,85992849,146384956,85982127,10722,0,0,0,0,0,0,146367490,17466,0,0,0,0,0,0
70.573,232377805,85992849,146384956,85982127,10722,0,0,0,0,0,0,146367490,17466,0,0,0,0,0,0
71.581,232377805,85992849,146384956,85982127,10722,0,0,0,0,0,0,146367490,17466,0,0,0,0,0,0
72.590,232377805,85992849,146384956,85982127,10722,0,0,0,0,0,0,146367490,17466,0,0,0,0,0,0
73.598,232377805,85992849,146384956,85982127,10722,0,0,0,0,0,0,146367490,17466,0,0,0,0,0,0
74.606,232377805,85992849,146384956,85982127,10722,0,0,0,0,0,0,146367490,17466,0,0,0,0,0,0
75.614,232377805,85992849,146384956,85982127,10722,0,0,0,0,0,0,146367490,17466,0,0,0,0,0,0
76.622,232377805,85992849,146384956,85982127,10722,0,0,0,0,0,0,146367490,17466,0,0,0,0,0,0
77.630,232377805,85992849,146384956,85982127,10722,0,0,0,0,0,0,146367490,17466,0,0,0,0,0,0
78.638,232377805,85992849,146384956,85982127,10722,0,0,0,0,0,0,146367490,17466,0,0,0,0,0,0
79.647,232377805,85992849,146384956,85982127,10722,0,0,0,0,0,0,146367490,17466,0,0,0,0,0,0
80.655,232377805,85992849,146384956,85982127,10722,0,0,0,0,0,0,146367490,17466,0,0,0,0,0,0
81.663,232377805,85992849,146384956,85982127,10722,0,0,0,0,0,0,146367490,17466,0,0,0,0,0,0
82.671,232377805,85992849,146384956,85982127,10722,0,0,0,0,0,0,146367490,17466,0,0,0,0,0,0
83.679,232377805,85992849,146384956,85982127,10722,0,0,0,0,0,0,146367490,17466,0,0,0,0,0,0
84.687,232377805,85992849,146384956,85982127,10722,0,0,0,0,0,0,146367490,17466,0,0,0,0,0,0
85.697,312789709,108033038,204756671,108019604,13434,0,0,0,0,0,0,204732448,24223,0,0,0,0,0,0
86.705,437871255,188668454,249202801,188645669,22785,0,0,0,0,0,0,249172989,29812,0,0,0,0,0,0
87.736,666265111,305104443,361160668,305067820,36623,0,0,0,0,0,0,361117535,43133,0,0,0,0,0,0
88.746,1051287421,497363744,553923677,497304733,59011,0,0,0,0,0,0,553858152,65525,0,0,0,0,0,0
89.789,1346285141,650520421,695764720,650443150,77271,0,0,0,0,0,0,695682374,82346,0,0,0,0,0,0
90.799,1673128271,807618873,865509398,807523107,95766,0,0,0,0,0,0,865407239,102159,0,0,0,0,0,0
91.831,1972637313,964050338,1008586975,963936252,114086,0,0,0,0,0,0,1008468027,118948,0,0,0,0,0,0
92.839,2294860656,1117207169,1177653487,1117075184,131985,0,0,0,0,0,0,1177514813,138674,0,0,0,0,0,0
93.875,2587967919,1273443738,1314524181,1273293355,150383,0,0,0,0,0,0,1314369362,154819,0,0,0,0,0,0
94.887,2913737648,1426665604,1487072044,1426497201,168403,0,0,0,0,0,0,1486897017,175027,0,0,0,0,0,0
95.896,3194489160,1586260309,1608228851,1586073432,186877,0,0,0,0,0,0,1608039531,189320,0,0,0,0,0,0
96.907,3532694895,1736093040,1796601855,1735888295,204745,0,0,0,0,0,0,1796390649,211206,0,0,0,0,0,0
97.917,3820592405,1894589817,1926002588,1894366742,223075,0,0,0,0,0,0,1925776264,226324,0,0,0,0,0,0
98.932,4150526969,2045368997,2105157972,2045128216,240781,0,0,0,0,0,0,2104910918,247054,0,0,0,0,0,0
99.951,4447843926,2200539233,2247304693,2200280277,258956,0,0,0,0,0,0,2247040778,263915,0,0,0,0,0,0
100.961,4770140986,2354819234,2415321752,2354542130,277104,0,0,0,0,0,0,2415038207,283545,0,0,0,0,0,0
101.980,5066064801,2517610116,2548454685,2517313919,296197,0,0,0,0,0,0,2548155284,299401,0,0,0,0,0,0
102.995,5389009450,2664267159,2724742291,2663953528,313631,0,0,0,0,0,0,2724422439,319852,0,0,0,0,0,0
104.006,5665048097,2797907020,2867141077,2797577700,329320,0,0,0,0,0,0,2866804665,336412,0,0,0,0,0,0
105.015,6006602462,2973561895,3033040567,2973211914,349981,0,0,0,0,0,0,3032684688,355879,0,0,0,0,0,0
106.035,6303184452,3128721203,3174463249,3128353238,367965,0,0,0,0,0,0,3174090918,372331,0,0,0,0,0,0
107.045,6626482558,3282947765,3343534793,3282561651,386114,0,0,0,0,0,0,3343142644,392149,0,0,0,0,0,0
108.060,6893926925,3412461379,3481465546,3412059859,401520,0,0,0,0,0,0,3481057263,408283,0,0,0,0,0,0
109.069,7209497475,3567870198,3641627277,3567450647,419551,0,0,0,0,0,0,3641200421,426856,0,0,0,0,0,0
110.100,7514221545,3731976595,3782244950,3731538048,438547,0,0,0,0,0,0,3781801536,443414,0,0,0,0,0,0
111.108,7859057129,3899599690,3959457439,3899141580,458110,0,0,0,0,0,0,3958993514,463925,0,0,0,0,0,0
112.126,8129976286,4038237771,4091738515,4037763120,474651,0,0,0,0,0,0,4091258913,479602,0,0,0,0,0,0
113.135,8478092066,4209464036,4268628030,4208969441,494595,0,0,0,0,0,0,4268127911,500119,0,0,0,0,0,0
114.158,8734223815,4341372352,4392851463,4340862249,510103,0,0,0,0,0,0,4392336715,514748,0,0,0,0,0,0
115.168,9097344482,4518385860,4578958622,4517855069,530791,0,0,0,0,0,0,4578422393,536229,0,0,0,0,0,0
116.204,9369235276,4658744978,4710490298,4658197591,547387,0,0,0,0,0,0,4709938543,551755,0,0,0,0,0,0
117.213,9716697703,4829170587,4887527116,4828603316,567271,0,0,0,0,0,0,4886954839,572277,0,0,0,0,0,0
118.247,9988823596,4966770066,5022053530,4966186540,583526,0,0,0,0,0,0,5021465343,588187,0,0,0,0,0,0
119.259,10335212202,5137570481,5197641721,5136966950,603531,0,0,0,0,0,0,5197033100,608621,0,0,0,0,0,0
120.303,10638951105,5298755347,5340195758,5298132701,622646,0,0,0,0,0,0,5339570383,625375,0,0,0,0,0,0
121.317,10957762013,5448768903,5508993110,5448128583,640320,0,0,0,0,0,0,5508348058,645052,0,0,0,0,0,0
122.328,11232060531,5582491427,5649569104,5581835328,656099,0,0,0,0,0,0,5648907665,661439,0,0,0,0,0,0
123.337,11573968894,5758140205,5815828689,5757463627,676578,0,0,0,0,0,0,5815147726,680963,0,0,0,0,0,0
124.359,11835744592,5887652928,5948091664,5886960968,691960,0,0,0,0,0,0,5947395174,696490,0,0,0,0,0,0
125.368,12190514427,6065379514,6125134913,6064666635,712879,0,0,0,0,0,0,6124417768,717145,0,0,0,0,0,0
126.414,12454539090,6197059583,6257479507,6196331111,728472,0,0,0,0,0,0,6256746762,732745,0,0,0,0,0,0
127.424,12809899845,6375378805,6434521040,6374629420,749385,0,0,0,0,0,0,6433767657,753383,0,0,0,0,0,0
128.452,13074887514,6508025585,6566861929,6507260613,764972,0,0,0,0,0,0,6566093004,768925,0,0,0,0,0,0
129.462,13432323915,6685909482,6746414433,6685123695,785787,0,0,0,0,0,0,6745624500,789933,0,0,0,0,0,0
130.475,13659783457,6804328905,6855454552,6803529156,799749,0,0,0,0,0,0,6854651733,802819,0,0,0,0,0,0
131.484,13992749424,6970956022,7021793402,6970136916,819106,0,0,0,0,0,0,7020971312,822090,0,0,0,0,0,0
132.494,14258357532,7098969557,7159387975,7098135298,834259,0,0,0,0,0,0,7158549678,838297,0,0,0,0,0,0
133.502,14639993318,7288607937,7351385381,7287751537,856400,0,0,0,0,0,0,7350524937,860444,0,0,0,0,0,0
134.511,14877196485,7408362601,7468833884,7407492029,870572,0,0,0,0,0,0,7467959447,874437,0,0,0,0,0,0
135.531,15261149643,7611245401,7649904242,7610351281,894120,0,0,0,0,0,0,7649008788,895454,0,0,0,0,0,0
136.540,15495980298,7717766966,7778213332,7716859926,907040,0,0,0,0,0,0,7777302740,910592,0,0,0,0,0,0
137.576,15889999648,7921512941,7968486707,7920582250,930691,0,0,0,0,0,0,7967554126,932581,0,0,0,0,0,0
138.585,16114745338,8027154982,8087590356,8026211677,943305,0,0,0,0,0,0,8086643658,946698,0,0,0,0,0,0
139.598,16497319089,8229713429,8267605660,8228746550,966879,0,0,0,0,0,0,8266638020,967640,0,0,0,0,0,0
140.607,16733531363,8336555694,8396975669,8335575944,979750,0,0,0,0,0,0,8395992739,982930,0,0,0,0,0,0
141.646,17140785439,8540721609,8600063830,8539718122,1003487,0,0,0,0,0,0,8599057348,1006482,0,0,0,0,0,0
142.655,17352630820,8646271388,8706359432,8645255422,1015966,0,0,0,0,0,0,8705340292,1019140,0,0,0,0,0,0
143.668,17759865869,8850340712,8909525157,8849301082,1039630,0,0,0,0,0,0,8908482408,1042749,0,0,0,0,0,0
144.677,17971737554,8955979721,9015757833,8954927532,1052189,0,0,0,0,0,0,9014702476,1055357,0,0,0,0,0,0
145.694,18352946407,9158392050,9194554357,9157316459,1075591,0,0,0,0,0,0,9193478167,1076190,0,0,0,0,0,0
146.704,18590512215,9265374316,9325137899,9264285908,1088408,0,0,0,0,0,0,9324046378,1091521,0,0,0,0,0,0
147.720,18944676454,9448042370,9496634084,9446932729,1109641,0,0,0,0,0,0,9495522708,1111376,0,0,0,0,0,0
148.729,19209281525,9574767430,9634514095,9573642678,1124752,0,0,0,0,0,0,9633386488,1127607,0,0,0,0,0,0
149.746,19566285611,9774294679,9791990932,9773146859,1147820,0,0,0,0,0,0,9790844866,1146066,0,0,0,0,0,0
150.754,19828042132,9884141623,9943900509,9882980796,1160827,0,0,0,0,0,0,9942736672,1163837,0,0,0,0,0,0
151.764,20153695372,10057527771,10096167601,10056346795,1180976,0,0,0,0,0,0,10094985948,1181653,0,0,0,0,0,0
152.772,20446816321,10193532021,10253284300,10192334882,1197139,0,0,0,0,0,0,10252084261,1200039,0,0,0,0,0,0
153.782,20728675644,10331401945,10397273699,10330188613,1213332,0,0,0,0,0,0,10396056901,1216798,0,0,0,0,0,0
154.790,21065604338,10502919045,10562685293,10501685648,1233397,0,0,0,0,0,0,10561449027,1236266,0,0,0,0,0,0
155.805,21374162157,10670153390,10704008767,10668900643,1252747,0,0,0,0,0,0,10702755940,1252827,0,0,0,0,0,0
156.834,21683644955,10811441943,10872203012,10810172573,1269370,0,0,0,0,0,0,10870930695,1272317,0,0,0,0,0,0
157.844,21973424105,10967359796,11006064309,10966072264,1287532,0,0,0,0,0,0,11004776076,1288233,0,0,0,0,0,0
158.853,22300468857,11121274319,11179194538,11119968801,1305518,0,0,0,0,0,0,11177886295,1308243,0,0,0,0,0,0
159.877,22565669053,11255312406,11310356647,11253991065,1321341,0,0,0,0,0,0,11309032886,1323761,0,0,0,0,0,0
160.887,22920558062,11429716381,11490841681,11428374722,1341659,0,0,0,0,0,0,11489496994,1344687,0,0,0,0,0,0
161.908,23187396708,11560463032,11626933676,11559105941,1357091,0,0,0,0,0,0,11625573007,1360669,0,0,0,0,0,0
162.917,23536723229,11739106582,11797616647,11737728802,1377780,0,0,0,0,0,0,11796236091,1380556,0,0,0,0,0,0
163.936,23795764232,11874075496,11921688736,11872681736,1393760,0,0,0,0,0,0,11920293453,1395283,0,0,0,0,0,0
164.949,24105588336,12017569101,12088019235,12016158539,1410562,0,0,0,0,0,0,12086604707,1414528,0,0,0,0,0,0
165.964,24376479587,12159632974,12216846613,12158205746,1427228,0,0,0,0,0,0,12215416936,1429677,0,0,0,0,0,0
166.974,24773249398,12356866378,12416383020,12355416298,1450080,0,0,0,0,0,0,12414930237,1452783,0,0,0,0,0,0
167.983,24985511627,12462360370,12523151257,12460897671,1462699,0,0,0,0,0,0,12521685738,1465519,0,0,0,0,0,0
168.993,25378184543,12665509037,12712675506,12664022791,1486246,0,0,0,0,0,0,12711187912,1487594,0,0,0,0,0,0
170.000,25604283094,12771749401,12832533693,12770250435,1498966,0,0,0,0,0,0,12831031996,1501697,0,0,0,0,0,0
171.012,25956577444,12952558215,13004019229,12951038260,1519955,0,0,0,0,0,0,13002497802,1521427,0,0,0,0,0,0
172.021,26223309809,13081404499,13141905310,13079869200,1535299,0,0,0,0,0,0,13140367595,1537715,0,0,0,0,0,0
173.040,26564989072,13265396536,13299592536,13263840036,1556500,0,0,0,0,0,0,13298036409,1556127,0,0,0,0,0,0
174.049,26842081845,13390792775,13451289070,13389221282,1571493,0,0,0,0,0,0,13449715170,1573900,0,0,0,0,0,0
175.065,27167721145,13550172151,13617548994,13548582165,1589986,0,0,0,0,0,0,13615955911,1593083,0,0,0,0,0,0
176.073,27460962015,13700172110,13760789905,13698564451,1607659,0,0,0,0,0,0,13759179994,1609911,0,0,0,0,0,0
177.083,27775362698,13863177961,13912184737,13861551341,1626620,0,0,0,0,0,0,13910557176,1627561,0,0,0,0,0,0
178.092,28079807266,14009640641,14070166625,14007996522,1644119,0,0,0,0,0,0,14068520590,1646035,0,0,0,0,0,0
179.103,28395142155,14176879824,14218262331,14175216175,1663649,0,0,0,0,0,0,14216598921,1663410,0,0,0,0,0,0
180.112,28698586916,14319044796,14379542120,14317364214,1680582,0,0,0,0,0,0,14377859986,1682134,0,0,0,0,0,0
181.122,29006121728,14479689737,14526431991,14477990452,1699285,0,0,0,0,0,0,14524732750,1699241,0,0,0,0,0,0
182.132,29317689858,14628763044,14688926814,14627046083,1716961,0,0,0,0,0,0,14687208467,1718347,0,0,0,0,0,0
183.146,29624144950,14789380215,14834764735,14787644623,1735592,0,0,0,0,0,0,14833029307,1735428,0,0,0,0,0,0
184.154,29936467474,14938149323,14998318151,14936396128,1753195,0,0,0,0,0,0,14996563481,1754670,0,0,0,0,0,0
185.169,30233314351,15100873016,15132441335,15099100970,1772046,0,0,0,0,0,0,15130670892,1770443,0,0,0,0,0,0
186.178,30555133640,15247479376,15307654264,15245690145,1789231,0,0,0,0,0,0,15305863431,1790833,0,0,0,0,0,0
187.187,30843940790,15402593521,15441347269,15400786221,1807300,0,0,0,0,0,0,15439540755,1806514,0,0,0,0,0,0
188.217,31139489947,15556708343,15582781604,15554883077,1825266,0,0,0,0,0,0,15580958451,1823153,0,0,0,0,0,0
189.242,31456296363,15700629806,15755666557,15698787441,1842365,0,0,0,0,0,0,15753823156,1843401,0,0,0,0,0,0
190.250,31792433103,15865711876,15926721227,15863850092,1861784,0,0,0,0,0,0,15924857904,1863323,0,0,0,0,0,0
191.292,32079399727,16015403569,16063996158,16013524268,1879301,0,0,0,0,0,0,16062116665,1879493,0,0,0,0,0,0
192.303,32393692621,16167809210,16225883411,16165911980,1897230,0,0,0,0,0,0,16223985050,1898361,0,0,0,0,0,0
193.332,32678732667,16304285759,16374446908,16302372531,1913228,0,0,0,0,0,0,16372531185,1915723,0,0,0,0,0,0
194.343,33012520223,16478961519,16533558704,16477028002,1933517,0,0,0,0,0,0,16531624413,1934291,0,0,0,0,0,0
195.370,33306484599,16623709882,16682774717,16621759230,1950652,0,0,0,0,0,0,16680822992,1951725,0,0,0,0,0,0
196.381,33646466280,16793992848,16852473432,16792022233,1970615,0,0,0,0,0,0,16850501874,1971558,0,0,0,0,0,0
197.393,33901632973,16923881809,16977751164,16921895849,1985960,0,0,0,0,0,0,16975764811,1986353,0,0,0,0,0,0
198.403,34263371836,17101515024,17161856812,17099508350,2006674,0,0,0,0,0,0,17159848980,2007832,0,0,0,0,0,0
199.418,34510284716,17224427536,17285857180,17222406418,2021118,0,0,0,0,0,0,17283834722,2022458,0,0,0,0,0,0
200.432,34882765231,17411491629,17471273602,17409448772,2042857,0,0,0,0,0,0,17469229548,2044054,0,0,0,0,0,0
201.445,35106253726,17524657035,17581596691,17522600667,2056368,0,0,0,0,0,0,17579539522,2057169,0,0,0,0,0,0
202.454,35500809309,17720299585,17780509724,17718220479,2079106,0,0,0,0,0,0,17778429406,2080318,0,0,0,0,0,0
203.462,35712541316,17825791851,17886749465,17823700155,2091696,0,0,0,0,0,0,17884656402,2093063,0,0,0,0,0,0
204.473,36118501375,18028941469,18089559906,18026826194,2115275,0,0,0,0,0,0,18087443427,2116479,0,0,0,0,0,0
205.481,36331314117,18135190702,18196123415,18133062628,2128074,0,0,0,0,0,0,18193994275,2129140,0,0,0,0,0,0
206.495,36701155204,18335332593,18365822611,18333181195,2151398,0,0,0,0,0,0,18363673633,2148978,0,0,0,0,0,0
207.503,36950082643,18444583430,18505499213,18442419014,2164416,0,0,0,0,0,0,18503333991,2165222,0,0,0,0,0,0
208.522,37315204116,18646604083,18668600033,18644416259,2187824,0,0,0,0,0,0,18666415701,2184332,0,0,0,0,0,0
209.531,37569014372,18753983411,18815030961,18751782585,2200826,0,0,0,0,0,0,18812829471,2201490,0,0,0,0,0,0
210.547,37887734340,18909332677,18978401663,18907113794,2218883,0,0,0,0,0,0,18976181340,2220323,0,0,0,0,0,0
211.555,38187787665,19063383937,19124403728,19061146820,2237117,0,0,0,0,0,0,19122166186,2237542,0,0,0,0,0,0
212.566,38493900500,19226379316,19267521184,19224123344,2255972,0,0,0,0,0,0,19265266943,2254241,0,0,0,0,0,0
213.577,38806548654,19372762162,19433786492,19370488911,2273251,0,0,0,0,0,0,19431512772,2273720,0,0,0,0,0,0
214.594,39109785996,19531255334,19578530662,19528963768,2291566,0,0,0,0,0,0,19576240251,2290411,0,0,0,0,0,0
215.602,39425188857,19682090405,19743098452,19679781145,2309260,0,0,0,0,0,0,19740788916,2309536,0,0,0,0,0,0
216.614,39709738522,19837193807,19872544715,19834866449,2327358,0,0,0,0,0,0,19870220024,2324691,0,0,0,0,0,0
217.624,40038438353,19988784799,20049653554,19986439580,2345219,0,0,0,0,0,0,20047308414,2345140,0,0,0,0,0,0
218.633,40250438947,20094664511,20155774436,20092306656,2357808,0,47,0,0,0,0,20153416719,2357717,0,0,0,0,0,0
219.661,40642924117,20296433074,20346491043,20294051889,2381138,0,47,0,0,0,0,20344111053,2379990,0,0,0,0,0,0
220.671,40869203627,20404042739,20465160888,20401648762,2393930,0,47,0,0,0,0,20462766913,2393975,0,0,0,0,0,0
221.686,41230383181,20593634155,20636749026,20591218257,2415851,0,47,0,0,0,0,20634335090,2413936,0,0,0,0,0,0
222.695,41487952430,20713417012,20774535418,20710986946,2430019,0,47,0,0,0,0,20772105360,2430058,0,0,0,0,0,0
223.728,41864457965,20913335481,20951122484,20910882094,2453340,0,47,0,0,0,0,20948671782,2450702,0,0,0,0,0,0
224.737,42106751517,21022823682,21083927835,21020357083,2466552,0,47,0,0,0,0,21081461541,2466294,0,0,0,0,0,0
225.762,42474072074,21225165019,21248907055,21222675092,2489880,0,47,0,0,0,0,21246421492,2485563,0,0,0,0,0,0
226.771,42725518396,21332208728,21393309668,21329705909,2502772,0,47,0,0,0,0,21390807186,2502482,0,0,0,0,0,0
227.810,43084431554,21521903346,21562528208,21519378584,2524715,0,47,0,0,0,0,21560006048,2522160,0,0,0,0,0,0
228.819,43344305534,21641612081,21702693453,21639072951,2539083,0,47,0,0,0,0,21700154742,2538711,0,0,0,0,0,0
229.828,43550462615,21744692844,21805769771,21742141707,2551090,0,47,0,0,0,0,21803219114,2550657,0,0,0,0,0,0
