time(sec),sum-all,sum-rcv,sum-trans,rcv-bytes,rcv-packets,rcv-errs,rcv-drop,rcv-fifo,rcv-frame,rcv-compressed,rcv-multicast,trans-bytes,trans-packets,trans-errs,trans-drop,trans-fifo,trans-colls,trans-carrier,trans-compressed
0.000,0,0,0,0,0,0,0,0,0,0,0,0,0,0,0,0,0,0,0
1.007,636,110,526,108,2,0,0,0,0,0,0,524,2,0,0,0,0,0,0
2.017,3945,275,3670,270,5,0,0,0,0,0,0,3660,10,0,0,0,0,0,0
3.024,5473,495,4978,486,9,0,0,0,0,0,0,4964,14,0,0,0,0,0,0
4.032,5473,495,4978,486,9,0,0,0,0,0,0,4964,14,0,0,0,0,0,0
5.039,5473,495,4978,486,9,0,0,0,0,0,0,4964,14,0,0,0,0,0,0
6.046,5473,495,4978,486,9,0,0,0,0,0,0,4964,14,0,0,0,0,0,0
7.053,5473,495,4978,486,9,0,0,0,0,0,0,4964,14,0,0,0,0,0,0
8.061,5473,495,4978,486,9,0,0,0,0,0,0,4964,14,0,0,0,0,0,0
9.068,5473,495,4978,486,9,0,0,0,0,0,0,4964,14,0,0,0,0,0,0
10.075,5473,495,4978,486,9,0,0,0,0,0,0,4964,14,0,0,0,0,0,0
11.081,6118,550,5568,540,10,0,0,0,0,0,0,5552,16,0,0,0,0,0,0
12.089,6118,550,5568,540,10,0,0,0,0,0,0,5552,16,0,0,0,0,0,0
13.096,128827,27753,101074,27707,46,0,0,0,0,0,0,101009,65,0,0,0,0,0,0
14.103,230230,116424,113806,116335,89,0,0,0,0,0,0,113699,107,0,0,0,0,0,0
15.110,42850156,42694659,155497,42689726,4933,0,0,0,0,0,0,155176,321,0,0,0,0,0,0
16.117,85452195,42782612,42669583,42777459,5153,0,0,0,0,0,0,42664502,5081,0,0,0,0,0,0
17.124,85452195,42782612,42669583,42777459,5153,0,0,0,0,0,0,42664502,5081,0,0,0,0,0,0
18.131,85452195,42782612,42669583,42777459,5153,0,0,0,0,0,0,42664502,5081,0,0,0,0,0,0
19.139,85452195,42782612,42669583,42777459,5153,0,0,0,0,0,0,42664502,5081,0,0,0,0,0,0
20.146,85452195,42782612,42669583,42777459,5153,0,0,0,0,0,0,42664502,5081,0,0,0,0,0,0
21.153,85452195,42782612,42669583,42777459,5153,0,0,0,0,0,0,42664502,5081,0,0,0,0,0,0
22.160,85452195,42782612,42669583,42777459,5153,0,0,0,0,0,0,42664502,5081,0,0,0,0,0,0
23.168,85452195,42782612,42669583,42777459,5153,0,0,0,0,0,0,42664502,5081,0,0,0,0,0,0
24.175,85452195,42782612,42669583,42777459,5153,0,0,0,0,0,0,42664502,5081,0,0,0,0,0,0
25.182,85452195,42782612,42669583,42777459,5153,0,0,0,0,0,0,42664502,5081,0,0,0,0,0,0
26.189,85452195,42782612,42669583,42777459,5153,0,0,0,0,0,0,42664502,5081,0,0,0,0,0,0
27.197,85452195,42782612,42669583,42777459,5153,0,0,0,0,0,0,42664502,5081,0,0,0,0,0,0
28.204,85452195,42782612,42669583,42777459,5153,0,0,0,0,0,0,42664502,5081,0,0,0,0,0,0
29.212,85452195,42782612,42669583,42777459,5153,0,0,0,0,0,0,42664502,5081,0,0,0,0,0,0
30.219,85452195,42782612,42669583,42777459,5153,0,0,0,0,0,0,42664502,5081,0,0,0,0,0,0
31.226,85452281,42782655,42669626,42777501,5154,0,0,0,0,0,0,42664544,5082,0,0,0,0,0,0
32.233,85452281,42782655,42669626,42777501,5154,0,0,0,0,0,0,42664544,5082,0,0,0,0,0,0
33.240,85452281,42782655,42669626,42777501,5154,0,0,0,0,0,0,42664544,5082,0,0,0,0,0,0
34.248,85452281,42782655,42669626,42777501,5154,0,0,0,0,0,0,42664544,5082,0,0,0,0,0,0
35.255,85452367,42782698,42669669,42777543,5155,0,0,0,0,0,0,42664586,5083,0,0,0,0,0,0
36.262,85452367,42782698,42669669,42777543,5155,0,0,0,0,0,0,42664586,5083,0,0,0,0,0,0
37.269,85452367,42782698,42669669,42777543,5155,0,0,0,0,0,0,42664586,5083,0,0,0,0,0,0
38.276,85452367,42782698,42669669,42777543,5155,0,0,0,0,0,0,42664586,5083,0,0,0,0,0,0
39.284,85452367,42782698,42669669,42777543,5155,0,0,0,0,0,0,42664586,5083,0,0,0,0,0,0
40.291,85452367,42782698,42669669,42777543,5155,0,0,0,0,0,0,42664586,5083,0,0,0,0,0,0
41.297,85452367,42782698,42669669,42777543,5155,0,0,0,0,0,0,42664586,5083,0,0,0,0,0,0
42.304,85452367,42782698,42669669,42777543,5155,0,0,0,0,0,0,42664586,5083,0,0,0,0,0,0
43.312,85452367,42782698,42669669,42777543,5155,0,0,0,0,0,0,42664586,5083,0,0,0,0,0,0
44.319,85575817,42811067,42764750,42805850,5217,0,0,0,0,0,0,42759617,5133,0,0,0,0,0,0
45.326,231330195,145862962,85467233,145846097,16865,0,0,0,0,0,0,85456901,10332,0,0,0,0,0,0
46.333,231822606,146090578,85732028,146073337,17241,0,0,0,0,0,0,85721489,10539,0,0,0,0,0,0
47.341,231822606,146090578,85732028,146073337,17241,0,0,0,0,0,0,85721489,10539,0,0,0,0,0,0
48.348,231822606,146090578,85732028,146073337,17241,0,0,0,0,0,0,85721489,10539,0,0,0,0,0,0
49.355,231822606,146090578,85732028,146073337,17241,0,0,0,0,0,0,85721489,10539,0,0,0,0,0,0
50.362,232044136,146311658,85732478,146294389,17269,0,0,0,0,0,0,85721934,10544,0,0,0,0,0,0
51.369,232044136,146311658,85732478,146294389,17269,0,0,0,0,0,0,85721934,10544,0,0,0,0,0,0
52.377,232044136,146311658,85732478,146294389,17269,0,0,0,0,0,0,85721934,10544,0,0,0,0,0,0
53.384,232044136,146311658,85732478,146294389,17269,0,0,0,0,0,0,85721934,10544,0,0,0,0,0,0
54.391,232044136,146311658,85732478,146294389,17269,0,0,0,0,0,0,85721934,10544,0,0,0,0,0,0
55.399,232044136,146311658,85732478,146294389,17269,0,0,0,0,0,0,85721934,10544,0,0,0,0,0,0
56.406,232044136,146311658,85732478,146294389,17269,0,0,0,0,0,0,85721934,10544,0,0,0,0,0,0
57.413,232266593,146312120,85954473,146294845,17275,0,0,0,0,0,0,85943902,10571,0,0,0,0,0,0
58.420,232374706,146367229,86007477,146349792,17437,0,0,0,0,0,0,85996751,10726,0,0,0,0,0,0
59.427,232374706,146367229,86007477,146349792,17437,0,0,0,0,0,0,85996751,10726,0,0,0,0,0,0
60.435,232374706,146367229,86007477,146349792,17437,0,0,0,0,0,0,85996751,10726,0,0,0,0,0,0
61.442,232374706,146367229,86007477,146349792,17437,0,0,0,0,0,0,85996751,10726,0,0,0,0,0,0
62.449,232374706,146367229,86007477,146349792,17437,0,0,0,0,0,0,85996751,10726,0,0,0,0,0,0
63.456,232374706,146367229,86007477,146349792,17437,0,0,0,0,0,0,85996751,10726,0,0,0,0,0,0
64.463,232374706,146367229,86007477,146349792,17437,0,0,0,0,0,0,85996751,10726,0,0,0,0,0,0
65.470,232374706,146367229,86007477,146349792,17437,0,0,0,0,0,0,85996751,10726,0,0,0,0,0,0
66.477,232374706,146367229,86007477,146349792,17437,0,0,0,0,0,0,85996751,10726,0,0,0,0,0,0
67.485,232374706,146367229,86007477,146349792,17437,0,0,0,0,0,0,85996751,10726,0,0,0,0,0,0
68.492,232374706,146367229,86007477,146349792,17437,0,0,0,0,0,0,85996751,10726,0,0,0,0,0,0
69.499,232374706,146367229,86007477,146349792,17437,0,0,0,0,0,0,85996751,10726,0,0,0,0,0,0
70.506,232374706,146367229,86007477,146349792,17437,0,0,0,0,0,0,85996751,10726,0,0,0,0,0,0
71.513,232374706,146367229,86007477,146349792,17437,0,0,0,0,0,0,85996751,10726,0,0,0,0,0,0
72.521,232374706,146367229,86007477,146349792,17437,0,0,0,0,0,0,85996751,10726,0,0,0,0,0,0
73.528,232374706,146367229,86007477,146349792,17437,0,0,0,0,0,0,85996751,10726,0,0,0,0,0,0
74.535,232374706,146367229,86007477,146349792,17437,0,0,0,0,0,0,85996751,10726,0,0,0,0,0,0
75.542,232374706,146367229,86007477,146349792,17437,0,0,0,0,0,0,85996751,10726,0,0,0,0,0,0
76.549,232374706,146367229,86007477,146349792,17437,0,0,0,0,0,0,85996751,10726,0,0,0,0,0,0
77.557,232374706,146367229,86007477,146349792,17437,0,0,0,0,0,0,85996751,10726,0,0,0,0,0,0
78.564,232374706,146367229,86007477,146349792,17437,0,0,0,0,0,0,85996751,10726,0,0,0,0,0,0
79.571,232374706,146367229,86007477,146349792,17437,0,0,0,0,0,0,85996751,10726,0,0,0,0,0,0
80.579,232374706,146367229,86007477,146349792,17437,0,0,0,0,0,0,85996751,10726,0,0,0,0,0,0
81.586,232374706,146367229,86007477,146349792,17437,0,0,0,0,0,0,85996751,10726,0,0,0,0,0,0
82.593,232374706,146367229,86007477,146349792,17437,0,0,0,0,0,0,85996751,10726,0,0,0,0,0,0
83.600,232374706,146367229,86007477,146349792,17437,0,0,0,0,0,0,85996751,10726,0,0,0,0,0,0
84.608,232374706,146367229,86007477,146349792,17437,0,0,0,0,0,0,85996751,10726,0,0,0,0,0,0
85.615,232374706,146367229,86007477,146349792,17437,0,0,0,0,0,0,85996751,10726,0,0,0,0,0,0
86.621,232374706,146367229,86007477,146349792,17437,0,0,0,0,0,0,85996751,10726,0,0,0,0,0,0
87.631,312227664,204144025,108083639,204119897,24128,0,0,0,0,0,0,108070198,13441,0,0,0,0,0,0
88.638,437545602,249114006,188431596,249084253,29753,0,0,0,0,0,0,188408856,22740,0,0,0,0,0,0
89.644,644980362,352660620,292319742,352618488,42132,0,0,0,0,0,0,292284567,35175,0,0,0,0,0,0
90.653,1034741291,548629762,486111529,548564952,64810,0,0,0,0,0,0,486053875,57654,0,0,0,0,0,0
91.661,1263779119,662052059,601727060,661973607,78452,0,0,0,0,0,0,601655301,71759,0,0,0,0,0,0
92.677,1670615166,865137597,805477569,865035583,102014,0,0,0,0,0,0,805382108,95461,0,0,0,0,0,0
93.685,1882551104,971432148,911118956,971317519,114629,0,0,0,0,0,0,911010854,108102,0,0,0,0,0,0
94.695,2288309895,1174052916,1114256979,1173914799,138117,0,0,0,0,0,0,1114125452,131527,0,0,0,0,0,0
95.702,2501327285,1280824256,1220503029,1280673327,150929,0,0,0,0,0,0,1220358727,144302,0,0,0,0,0,0
96.723,2891698856,1467447948,1424250908,1467275298,172650,0,0,0,0,0,0,1424082931,167977,0,0,0,0,0,0
97.730,3120093318,1590204507,1529888811,1590017437,187070,0,0,0,0,0,0,1529708273,180538,0,0,0,0,0,0
98.756,3527591211,1793087128,1734504083,1792876579,210549,0,0,0,0,0,0,1734299739,204344,0,0,0,0,0,0
99.763,3738868076,1899586299,1839281777,1899363066,223233,0,0,0,0,0,0,1839064901,216876,0,0,0,0,0,0
100.776,4115858254,2089059558,2026798696,2088814542,245016,0,0,0,0,0,0,2026560194,238502,0,0,0,0,0,0
101.786,4357684108,2208972585,2148711523,2208713121,259464,0,0,0,0,0,0,2148458436,253087,0,0,0,0,0,0
102.810,4764245078,2411791442,2352453636,2411508449,282993,0,0,0,0,0,0,2352176910,276726,0,0,0,0,0,0
103.818,4976937773,2518372385,2458565388,2518076496,295889,0,0,0,0,0,0,2458275876,289512,0,0,0,0,0,0
104.833,5377535182,2714924149,2662611033,2714605598,318551,0,0,0,0,0,0,2662297873,313160,0,0,0,0,0,0
105.840,5595736379,2827742859,2767993520,2827410936,331923,0,0,0,0,0,0,2767667660,325860,0,0,0,0,0,0
106.876,5973666370,3007872606,2965793764,3007519693,352913,0,0,0,0,0,0,2965444870,348894,0,0,0,0,0,0
107.884,6214573658,3137183282,3077390376,3136815257,368025,0,0,0,0,0,0,3077028204,362172,0,0,0,0,0,0
108.919,6614998742,3333597017,3281401725,3333206117,390900,0,0,0,0,0,0,3281015897,385828,0,0,0,0,0,0
109.927,6833357831,3446571444,3386786387,3446167142,404302,0,0,0,0,0,0,3386387859,398528,0,0,0,0,0,0
110.937,7186002385,3618062742,3567939643,3617638640,424102,0,0,0,0,0,0,3567520201,419442,0,0,0,0,0,0
111.943,7452101264,3755946503,3696154761,3755506126,440377,0,0,0,0,0,0,3695720248,434513,0,0,0,0,0,0
112.952,7791548210,3911640447,3879907763,3911181935,458512,0,0,0,0,0,0,3879451944,455819,0,0,0,0,0,0
113.960,8070884555,4065324652,4005559903,4064848169,476483,0,0,0,0,0,0,4005088976,470927,0,0,0,0,0,0
114.973,8383715634,4209055141,4174660493,4208561814,493327,0,0,0,0,0,0,4174169958,490535,0,0,0,0,0,0
115.981,8689645491,4374702726,4314942765,4374190096,512630,0,0,0,0,0,0,4314435644,507121,0,0,0,0,0,0
116.990,9009872283,4526094358,4483777925,4525564168,530190,0,0,0,0,0,0,4483251220,526705,0,0,0,0,0,0
117.998,9308471172,4684074696,4624396476,4683526050,548646,0,0,0,0,0,0,4623853044,543432,0,0,0,0,0,0
119.009,9623938394,4835464338,4788474056,4834898054,566284,0,0,0,0,0,0,4787911477,562579,0,0,0,0,0,0
120.017,9927251353,4993460207,4933791146,4992875311,584896,0,0,0,0,0,0,4933211336,579810,0,0,0,0,0,0
121.025,10241375418,5140345920,5101029498,5139743939,601981,0,0,0,0,0,0,5100430278,599220,0,0,0,0,0,0
122.034,10546102069,5302906043,5243196026,5302284971,621072,0,0,0,0,0,0,5242579691,616335,0,0,0,0,0,0
123.045,10852234205,5446024739,5406209466,5445386966,637773,0,0,0,0,0,0,5405574167,635299,0,0,0,0,0,0
124.052,11164872993,5612284434,5552588559,5611627235,657199,0,0,0,0,0,0,5551935889,652670,0,0,0,0,0,0
125.061,11477933939,5758109632,5719824307,5757435371,674261,0,0,0,0,0,0,5719152243,672064,0,0,0,0,0,0
126.077,11783557260,5921619335,5861937925,5920925985,693350,0,0,0,0,0,0,5861249026,688899,0,0,0,0,0,0
127.088,12083844392,6062569170,6021275222,6061859281,709889,0,0,0,0,0,0,6020567645,707577,0,0,0,0,0,0
128.097,12399463284,6228189460,6171273824,6227460190,729270,0,0,0,0,0,0,6170548457,725367,0,0,0,0,0,0
129.111,12683757171,6359615145,6324142026,6358870405,744740,0,0,0,0,0,0,6323398670,743356,0,0,0,0,0,0
130.120,13017805007,6537559902,6480245105,6536794547,765355,0,0,0,0,0,0,6479483438,761667,0,0,0,0,0,0
131.151,13310987457,6677833704,6633153753,6677051712,781992,0,0,0,0,0,0,6632374235,779518,0,0,0,0,0,0
132.158,13594000488,6817325536,6776674952,6816527165,798371,0,0,0,0,0,0,6775878531,796421,0,0,0,0,0,0
133.178,13905737140,6978984539,6926752601,6978167458,817081,0,0,0,0,0,0,6925938612,813989,0,0,0,0,0,0
134.187,14253925381,7156253658,7097671723,7155416000,837658,0,0,0,0,0,0,7096837838,833885,0,0,0,0,0,0
135.207,14495751627,7270878899,7224872728,7270027613,851286,0,0,0,0,0,0,7224023670,849058,0,0,0,0,0,0
136.214,14845691711,7452174116,7393517595,7451301861,872255,0,0,0,0,0,0,7392648966,868629,0,0,0,0,0,0
137.221,15084007023,7571777178,7512229845,7570890766,886412,0,0,0,0,0,0,7511346985,882860,0,0,0,0,0,0
138.235,15492123008,7774863164,7717259844,7773953219,909945,0,0,0,0,0,0,7716353128,906716,0,0,0,0,0,0
139.242,15702779511,7881151124,7821628387,7880228626,922498,0,0,0,0,0,0,7820709127,919260,0,0,0,0,0,0
140.257,16105363339,8079990046,8025373293,8079044436,945610,0,0,0,0,0,0,8024430423,942870,0,0,0,0,0,0
141.265,16321555932,8190535867,8131020065,8189577137,958730,0,0,0,0,0,0,8130064486,955579,0,0,0,0,0,0
142.279,16721151630,8387778758,8333372872,8386797200,981558,0,0,0,0,0,0,8332393793,979079,0,0,0,0,0,0
143.286,16940344904,8499926169,8440418735,8498931144,995025,0,0,0,0,0,0,8439426744,991991,0,0,0,0,0,0
144.295,17343506924,8699609694,8643897230,8698591594,1018100,0,0,0,0,0,0,8642881688,1015542,0,0,0,0,0,0
145.303,17559433230,8809304400,8750128830,8808273241,1031159,0,0,0,0,0,0,8749100704,1028126,0,0,0,0,0,0
146.316,17937215145,8984087678,8953127467,8983036101,1051577,0,0,0,0,0,0,8952075887,1051580,0,0,0,0,0,0
147.324,18178590888,9118692671,9059898217,9117625314,1067357,0,0,0,0,0,0,9058833898,1064319,0,0,0,0,0,0
148.341,18534404702,9286479164,9247925538,9285392182,1086982,0,0,0,0,0,0,9246839350,1086188,0,0,0,0,0,0
149.350,18797375467,9428073669,9369301798,9426970139,1103530,0,0,0,0,0,0,9368201126,1100672,0,0,0,0,0,0
150.361,19126175110,9580336332,9545838778,9579215176,1121156,0,0,0,0,0,0,9544717662,1121116,0,0,0,0,0,0
151.368,19416173879,9737448275,9678725604,9736308693,1139582,0,0,0,0,0,0,9677588653,1136951,0,0,0,0,0,0
152.380,19730896809,9877174577,9853722232,9876018543,1156034,0,0,0,0,0,0,9852565138,1157094,0,0,0,0,0,0
153.387,20034991949,10046837546,9988154403,10045661692,1175854,0,0,0,0,0,0,9986981368,1173035,0,0,0,0,0,0
154.397,20350457857,10198231606,10152226251,10197038083,1193523,0,0,0,0,0,0,10151034134,1192117,0,0,0,0,0,0
155.404,20653771881,10356223393,10297548488,10355011292,1212101,0,0,0,0,0,0,10296339083,1209405,0,0,0,0,0,0
156.414,20962328479,10502060425,10460268054,10500831330,1229095,0,0,0,0,0,0,10459039861,1228193,0,0,0,0,0,0
157.423,21272454120,10665573766,10606880354,10664325582,1248184,0,0,0,0,0,0,10605634931,1245423,0,0,0,0,0,0
158.431,21527658923,10787103144,10740555779,10785840689,1262455,0,0,0,0,0,0,10739294684,1261095,0,0,0,0,0,0
159.445,21886605493,10973000186,10913605307,10971716090,1284096,0,0,0,0,0,0,10912324035,1281272,0,0,0,0,0,0
160.457,22110169716,11082720359,11027449357,11081423245,1297114,0,0,0,0,0,0,11026154696,1294661,0,0,0,0,0,0
161.466,22504869613,11281513727,11223355886,11280193587,1320140,0,0,0,0,0,0,11222038522,1317364,0,0,0,0,0,0
162.474,22716866355,11387860402,11329005953,11386527598,1332804,0,0,0,0,0,0,11327675864,1330089,0,0,0,0,0,0
163.484,23122100506,11590744754,11531355752,11589388452,1356302,0,0,0,0,0,0,11530002220,1353532,0,0,0,0,0,0
164.493,23335628869,11697238276,11638390593,11695869337,1368939,0,0,0,0,0,0,11637024308,1366285,0,0,0,0,0,0
165.503,23701097764,11877284346,11823813418,11875894472,1389874,0,0,0,0,0,0,11822425640,1387778,0,0,0,0,0,0
166.511,23954436387,12006624825,11947811562,12005219661,1405164,0,0,0,0,0,0,11946409059,1402503,0,0,0,0,0,0
167.523,24306240298,12178414058,12127826240,12176989082,1424976,0,0,0,0,0,0,12126402954,1423286,0,0,0,0,0,0
168.530,24573907933,12316704273,12257203660,12315262929,1441344,0,0,0,0,0,0,12255764973,1438687,0,0,0,0,0,0
169.538,24895550839,12469239506,12426311333,12467780398,1459108,0,0,0,0,0,0,12424852987,1458346,0,0,0,0,0,0
170.546,25192681957,12626091453,12566590504,12624613843,1477610,0,0,0,0,0,0,12565115579,1474925,0,0,0,0,0,0
171.556,25512353626,12777468571,12734885055,12775973395,1495176,0,0,0,0,0,0,12733390628,1494427,0,0,0,0,0,0
172.563,25811708516,12935462727,12876245789,12933949106,1513621,0,0,0,0,0,0,12874734512,1511277,0,0,0,0,0,0
173.572,26104085020,13064847569,13039237451,13063318897,1528672,0,0,0,0,0,0,13037707397,1530054,0,0,0,0,0,0
174.579,26430476827,13244845207,13185631620,13243295429,1549778,0,0,0,0,0,0,13184084147,1547473,0,0,0,0,0,0
175.588,26735895055,13390674192,13345220863,13389107450,1566742,0,0,0,0,0,0,13343654898,1565965,0,0,0,0,0,0
176.597,27049255742,13554218810,13495036932,13552632977,1585833,0,0,0,0,0,0,13493453247,1583685,0,0,0,0,0,0
177.610,27327257471,13691167129,13636090342,13689565426,1601703,0,0,0,0,0,0,13634490355,1599987,0,0,0,0,0,0
178.620,27663645162,13860633598,13803011564,13859012220,1621378,0,0,0,0,0,0,13801391992,1619572,0,0,0,0,0,0
179.632,27932745769,13987831920,13944913849,13986195505,1636415,0,0,0,0,0,0,13943277552,1636297,0,0,0,0,0,0
180.639,28281623305,14169958768,14111664537,14168301191,1657577,0,0,0,0,0,0,14110008608,1655929,0,0,0,0,0,0
181.651,28539900550,14294224560,14245675990,14292552355,1672205,0,0,0,0,0,0,14244004189,1671801,0,0,0,0,0,0
182.661,28899996248,14479590245,14420406003,14477896693,1693552,0,0,0,0,0,0,14418713828,1692175,0,0,0,0,0,0
183.680,29154190045,14601490920,14552699125,14599782949,1707971,0,0,0,0,0,0,14550991237,1707888,0,0,0,0,0,0
184.689,29519721294,14788976493,14730744801,14787246685,1729808,0,0,0,0,0,0,14729016100,1728701,0,0,0,0,0,0
185.701,29771686413,14912651146,14859035267,14910906617,1744529,0,0,0,0,0,0,14857291499,1743768,0,0,0,0,0,0
186.710,30138518093,15098307168,15040210925,15096540962,1766206,0,0,0,0,0,0,15038446005,1764920,0,0,0,0,0,0
187.719,30359261695,15208195939,15151065756,15206416602,1779337,0,0,0,0,0,0,15149287613,1778143,0,0,0,0,0,0
188.726,30756844936,15407470569,15349374367,15405668183,1802386,0,0,0,0,0,0,15347573329,1801038,0,0,0,0,0,0
189.733,30968774378,15513763369,15455011009,15511948413,1814956,0,0,0,0,0,0,15453197421,1813588,0,0,0,0,0,0
190.762,31357950790,15700322122,15657628668,15698485376,1836746,0,0,0,0,0,0,15655791548,1837120,0,0,0,0,0,0
191.769,31588267433,15823851246,15764416187,15821999827,1851419,0,0,0,0,0,0,15762566085,1850102,0,0,0,0,0,0
192.783,31943087145,15985370660,15957716485,15983500295,1870365,0,0,0,0,0,0,15955843943,1872542,0,0,0,0,0,0
193.792,32207078950,16133236519,16073842431,16131348863,1887656,0,0,0,0,0,0,16071956008,1886423,0,0,0,0,0,0
194.799,32528953730,16285759692,16243194038,16283854272,1905420,0,0,0,0,0,0,16241288064,1905974,0,0,0,0,0,0
195.806,32825867885,16442645187,16383222698,16440721380,1923807,0,0,0,0,0,0,16381300109,1922589,0,0,0,0,0,0
196.814,33138417177,16586360021,16552057156,16584419503,1940518,0,0,0,0,0,0,16550115006,1942150,0,0,0,0,0,0
197.821,33444940878,16752026498,16692914380,16750066547,1959951,0,0,0,0,0,0,16690955420,1958960,0,0,0,0,0,0
198.830,33755400225,16895150257,16860249968,16893173553,1976704,0,0,0,0,0,0,16858271536,1978432,0,0,0,0,0,0
199.838,34063805777,17061412419,17002393358,17059416244,1996175,0,0,0,0,0,0,17000398123,1995235,0,0,0,0,0,0
200.848,34374495752,17207249783,17167245969,17205236514,2013269,0,0,0,0,0,0,17165231645,2014324,0,0,0,0,0,0
201.856,34682579523,17370801783,17311777740,17368769320,2032463,0,0,0,0,0,0,17309746313,2031427,0,0,0,0,0,0
202.867,34987792570,17513287704,17474504866,17511238620,2049084,0,0,0,0,0,0,17472454628,2050238,0,0,0,0,0,0
203.876,35298569620,17677469640,17621099980,17675401454,2068186,0,0,0,0,0,0,17619032458,2067522,0,0,0,0,0,0
204.885,35581454248,17818176066,17763278182,17816091203,2084863,0,0,0,0,0,0,17761193918,2084264,0,0,0,0,0,0
205.893,35917093602,17989332472,17927761130,17987227608,2104864,0,0,0,0,0,0,17925657635,2103495,0,0,0,0,0,0
206.913,36203188350,18119296549,18083891801,18117176420,2120129,0,0,0,0,0,0,18081770013,2121788,0,0,0,0,0,0
207.921,36533341954,18296191559,18237150395,18294050954,2140605,0,0,0,0,0,0,18235010585,2139810,0,0,0,0,0,0
208.935,36804378459,18426543657,18377834802,18424387724,2155933,0,0,0,0,0,0,18375678245,2156557,0,0,0,0,0,0
209.945,37124134789,18592169506,18531965283,18589994381,2175125,0,0,0,0,0,0,18529790762,2174521,0,0,0,0,0,0
210.970,37419535357,18733953885,18685581472,18731762035,2191850,0,0,0,0,0,0,18683388885,2192587,0,0,0,0,0,0
211.978,37770730109,18914740708,18855989401,18912527894,2212814,0,0,0,0,0,0,18853776851,2212550,0,0,0,0,0,0
213.002,38007227691,19027535187,18979692504,19025309035,2226152,0,0,0,0,0,0,18977465444,2227060,0,0,0,0,0,0
214.011,38318166703,19184406238,19133760465,19182161755,2244483,0,0,0,0,0,0,19131515271,2245194,0,0,0,0,0,0
215.018,38601754791,19330465540,19271289251,19328203916,2261624,0,0,0,0,0,0,19269027830,2261421,0,0,0,0,0,0
216.044,38948926458,19487024506,19461901952,19484744618,2279888,0,0,0,0,0,0,19459618500,2283452,0,0,0,0,0,0
217.052,39220507428,19639832536,19580674892,19637534945,2297591,0,0,0,0,0,0,19578377257,2297635,0,0,0,0,0,0
218.063,39547526407,19784091773,19763434634,19781777372,2314401,0,0,0,0,0,0,19761115911,2318723,0,0,0,0,0,0
219.070,39839258626,19949201820,19890056806,19946868226,2333594,0,0,0,0,0,0,19887723006,2333800,0,0,0,0,0,0
220.081,40112217911,20092318478,20019899433,20089968337,2350141,0,0,0,0,0,0,20017550427,2349006,0,0,0,0,0,0
221.091,40458491347,20258659038,20199832309,20256289387,2369651,0,0,0,0,0,0,20197462355,2369954,0,0,0,0,0,0
222.108,40758144974,20398974396,20359170578,20396588272,2386124,0,0,0,0,0,0,20356782059,2388519,0,0,0,0,0,0
223.116,41077153267,20568000044,20509153223,20565594209,2405835,0,0,0,0,0,0,20506747152,2406071,0,0,0,0,0,0
224.137,41344654640,20701733523,20642921117,20699312032,2421491,0,0,0,0,0,0,20640499471,2421646,0,0,0,0,0,0
225.145,41692758456,20874525392,20818233064,20872083832,2441560,0,0,0,0,0,0,20815790919,2442145,0,0,0,0,0,0
226.159,41937125240,20989078360,20948046880,20986623215,2455145,0,0,0,0,0,0,20945589243,2457637,0,0,0,0,0,0
227.167,42309649243,21183896396,21125752847,21181418685,2477711,0,0,0,0,0,0,21123274455,2478392,0,0,0,0,0,0
228.179,42537409276,21297963571,21239445705,21295472337,2491234,0,0,0,0,0,0,21236953832,2491873,0,0,0,0,0,0
229.186,42928193116,21492863449,21435329667,21490349603,2513846,0,0,0,0,0,0,21432815100,2514567,0,0,0,0,0,0
230.196,43139916283,21599355310,21540560973,21596828828,2526482,0,0,0,0,0,0,21538033788,2527185,0,0,0,0,0,0
231.205,43546721585,21802246668,21744474917,21799696581,2550087,0,0,0,0,0,0,21741923967,2550950,0,0,0,0,0,0
232.212,43552353015,21805565071,21746787944,21803014482,2550589,0,0,0,0,0,0,21744236599,2551345,0,0,0,0,0,0
