time(sec),sum-all,sum-rcv,sum-trans,rcv-bytes,rcv-packets,rcv-errs,rcv-drop,rcv-fifo,rcv-frame,rcv-compressed,rcv-multicast,trans-bytes,trans-packets,trans-errs,trans-drop,trans-fifo,trans-colls,trans-carrier,trans-compressed
0.000,0,0,0,0,0,0,0,0,0,0,0,0,0,0,0,0,0,0,0
1.008,0,0,0,0,0,0,0,0,0,0,0,0,0,0,0,0,0,0,0
2.015,3002,330,2672,324,6,0,0,0,0,0,0,2664,8,0,0,0,0,0,0
3.023,5041,495,4546,486,9,0,0,0,0,0,0,4532,14,0,0,0,0,0,0
4.030,7926,605,7321,594,11,0,0,0,0,0,0,7302,19,0,0,0,0,0,0
5.037,7926,605,7321,594,11,0,0,0,0,0,0,7302,19,0,0,0,0,0,0
6.044,7926,605,7321,594,11,0,0,0,0,0,0,7302,19,0,0,0,0,0,0
7.051,7926,605,7321,594,11,0,0,0,0,0,0,7302,19,0,0,0,0,0,0
8.059,7926,605,7321,594,11,0,0,0,0,0,0,7302,19,0,0,0,0,0,0
9.065,8012,648,7364,636,12,0,0,0,0,0,0,7344,20,0,0,0,0,0,0
10.073,8012,648,7364,636,12,0,0,0,0,0,0,7344,20,0,0,0,0,0,0
11.079,8098,691,7407,678,13,0,0,0,0,0,0,7386,21,0,0,0,0,0,0
12.086,8098,691,7407,678,13,0,0,0,0,0,0,7386,21,0,0,0,0,0,0
13.093,8098,691,7407,678,13,0,0,0,0,0,0,7386,21,0,0,0,0,0,0
14.099,8098,691,7407,678,13,0,0,0,0,0,0,7386,21,0,0,0,0,0,0
15.106,8098,691,7407,678,13,0,0,0,0,0,0,7386,21,0,0,0,0,0,0
16.113,8098,691,7407,678,13,0,0,0,0,0,0,7386,21,0,0,0,0,0,0
17.120,8098,691,7407,678,13,0,0,0,0,0,0,7386,21,0,0,0,0,0,0
18.126,8098,691,7407,678,13,0,0,0,0,0,0,7386,21,0,0,0,0,0,0
19.133,8098,691,7407,678,13,0,0,0,0,0,0,7386,21,0,0,0,0,0,0
20.139,8098,691,7407,678,13,0,0,0,0,0,0,7386,21,0,0,0,0,0,0
21.146,8751,746,8005,732,14,0,0,0,0,0,0,7982,23,0,0,0,0,0,0
22.153,8751,746,8005,732,14,0,0,0,0,0,0,7982,23,0,0,0,0,0,0
23.160,8751,746,8005,732,14,0,0,0,0,0,0,7982,23,0,0,0,0,0,0
24.167,8751,746,8005,732,14,0,0,0,0,0,0,7982,23,0,0,0,0,0,0
25.174,134607,29974,104633,29915,59,0,0,0,0,0,0,104549,84,0,0,0,0,0,0
26.181,134607,29974,104633,29915,59,0,0,0,0,0,0,104549,84,0,0,0,0,0,0
27.188,134607,29974,104633,29915,59,0,0,0,0,0,0,104549,84,0,0,0,0,0,0
28.194,257720,32919,224801,32846,73,0,0,0,0,0,0,224690,111,0,0,0,0,0,0
29.200,304407,34742,269665,34643,99,0,0,0,0,0,0,269488,177,0,0,0,0,0,0
30.208,304407,34742,269665,34643,99,0,0,0,0,0,0,269488,177,0,0,0,0,0,0
31.214,145884012,103081495,42802517,103069804,11691,0,0,0,0,0,0,42797301,5216,0,0,0,0,0,0
32.221,145890702,103084266,42806436,103072553,11713,0,0,0,0,0,0,42801201,5235,0,0,0,0,0,0
33.228,188598161,145736066,42862095,145719543,16523,0,0,0,0,0,0,42856437,5658,0,0,0,0,0,0
34.234,188598161,145736066,42862095,145719543,16523,0,0,0,0,0,0,42856437,5658,0,0,0,0,0,0
35.240,188598161,145736066,42862095,145719543,16523,0,0,0,0,0,0,42856437,5658,0,0,0,0,0,0
36.247,188652728,145788716,42864012,145772180,16536,0,0,0,0,0,0,42858345,5667,0,0,0,0,0,0
37.253,188652728,145788716,42864012,145772180,16536,0,0,0,0,0,0,42858345,5667,0,0,0,0,0,0
38.259,188652728,145788716,42864012,145772180,16536,0,0,0,0,0,0,42858345,5667,0,0,0,0,0,0
39.266,231195334,145818753,85376581,145802116,16637,0,0,0,0,0,0,85366179,10402,0,0,0,0,0,0
40.273,232362862,146265195,86097667,146248411,16784,0,0,0,0,0,0,86087017,10650,0,0,0,0,0,0
41.280,232365899,146265986,86099913,146249194,16792,0,0,0,0,0,0,86089252,10661,0,0,0,0,0,0
42.288,232365899,146265986,86099913,146249194,16792,0,0,0,0,0,0,86089252,10661,0,0,0,0,0,0
43.295,232365899,146265986,86099913,146249194,16792,0,0,0,0,0,0,86089252,10661,0,0,0,0,0,0
44.302,232365899,146265986,86099913,146249194,16792,0,0,0,0,0,0,86089252,10661,0,0,0,0,0,0
45.309,232365899,146265986,86099913,146249194,16792,0,0,0,0,0,0,86089252,10661,0,0,0,0,0,0
46.316,232582742,146482258,86100484,146465439,16819,0,0,0,0,0,0,86089816,10668,0,0,0,0,0,0
47.323,232889540,146526900,86362640,146510042,16858,0,0,0,0,0,0,86351912,10728,0,0,0,0,0,0
48.330,232889540,146526900,86362640,146510042,16858,0,0,0,0,0,0,86351912,10728,0,0,0,0,0,0
49.337,232889540,146526900,86362640,146510042,16858,0,0,0,0,0,0,86351912,10728,0,0,0,0,0,0
50.346,350599938,198871280,151728658,198848132,23148,0,0,0,0,0,0,151710483,18175,0,0,0,0,0,0
51.353,439170762,249678257,189492505,249648966,29291,0,0,0,0,0,0,189469674,22831,0,0,0,0,0,0
52.363,934896480,495444069,439452411,495385837,58232,0,0,0,0,0,0,439400551,51860,0,0,0,0,0,0
53.369,1470461328,765366420,705094908,765275930,90490,0,0,0,0,0,0,705012117,82791,0,0,0,0,0,0
54.376,1882993736,971652907,911340829,971537780,115127,0,0,0,0,0,0,911233982,106847,0,0,0,0,0,0
55.384,2298354284,1178751004,1119603280,1178611426,139578,0,0,0,0,0,0,1119472323,130957,0,0,0,0,0,0
56.392,2914222482,1487321324,1426901158,1487144820,176504,0,0,0,0,0,0,1426734723,166435,0,0,0,0,0,0
57.401,3326811950,1693657749,1633154201,1693456308,201441,0,0,0,0,0,0,1632963849,190352,0,0,0,0,0,0
58.406,3739320495,1899927743,1839392752,1899701902,225841,0,0,0,0,0,0,1839178452,214300,0,0,0,0,0,0
59.416,4298467318,2173345277,2125122041,2173086788,258489,0,0,0,0,0,0,2124874547,247494,0,0,0,0,0,0
60.424,4770627285,2415640643,2354986642,2415353213,287430,0,0,0,0,0,0,2354712490,274152,0,0,0,0,0,0
61.430,5183173586,2621944109,2561229477,2621631774,312335,0,0,0,0,0,0,2560931305,298172,0,0,0,0,0,0
62.438,5607558952,2832679230,2774879722,2832341635,337595,0,0,0,0,0,0,2774556644,323078,0,0,0,0,0,0
63.445,6214508096,3137657144,3076850952,3137283226,373918,0,0,0,0,0,0,3076492522,358430,0,0,0,0,0,0
64.453,6627032286,3343941300,3283090986,3343542768,398532,0,0,0,0,0,0,3282708592,382394,0,0,0,0,0,0
65.461,7039562690,3550232342,3489330348,3549809088,423254,0,0,0,0,0,0,3488923994,406354,0,0,0,0,0,0
66.472,7582182857,3818066130,3764116727,3817610995,455135,0,0,0,0,0,0,3763678615,438112,0,0,0,0,0,0
67.480,8070854053,4065946428,4004907625,4065461572,484856,0,0,0,0,0,0,4004441694,465931,0,0,0,0,0,0
68.488,8483383384,4272239945,4211143439,4271730330,509615,0,0,0,0,0,0,4210653601,489838,0,0,0,0,0,0
69.495,8895901880,4478536564,4417365316,4478002156,534408,0,0,0,0,0,0,4416851776,513540,0,0,0,0,0,0
70.502,9514666741,4787961472,4726705269,4787390156,571316,0,0,0,0,0,0,4726156069,549200,0,0,0,0,0,0
71.510,9927176878,4994227952,4932948926,4993632276,595676,0,0,0,0,0,0,4932375694,573232,0,0,0,0,0,0
72.517,10339703835,5200524352,5139179483,5199903871,620481,0,0,0,0,0,0,5138582415,597068,0,0,0,0,0,0
73.527,10883011167,5468807992,5414203175,5468155438,652554,0,0,0,0,0,0,5413574369,628806,0,0,0,0,0,0
74.534,11370989197,5716250569,5654738628,5715568311,682258,0,0,0,0,0,0,5654082227,656401,0,0,0,0,0,0
75.542,11783518243,5922550230,5860968013,5921843126,707104,0,0,0,0,0,0,5860287796,680217,0,0,0,0,0,0
76.548,12196066184,6128854337,6067211847,6128122318,732019,0,0,0,0,0,0,6066507597,704250,0,0,0,0,0,0
77.561,12814859688,6438287773,6376571915,6437518714,769059,0,0,0,0,0,0,6375831697,740218,0,0,0,0,0,0
78.569,13227364834,6644562945,6582801889,6643769401,793544,0,0,0,0,0,0,6582037848,764041,0,0,0,0,0,0
79.576,13639877175,6850842718,6789034457,6850024623,818095,0,0,0,0,0,0,6788246547,787910,0,0,0,0,0,0
80.585,14207536470,7121267058,7086269412,7120416576,850482,0,0,0,0,0,0,7085447233,822179,0,0,0,0,0,0
81.594,14671166154,7366556938,7304609216,7365677239,879699,0,0,0,0,0,0,7303761758,847458,0,0,0,0,0,0
82.602,15083687607,7572853009,7510834598,7571948530,904479,0,0,0,0,0,0,7509963386,871212,0,0,0,0,0,0
83.610,15526539211,7792696366,7733842845,7791765702,930664,0,0,0,0,0,0,7732945819,897026,0,0,0,0,0,0
84.617,16114980682,8088552130,8026428552,8087586291,965839,0,0,0,0,0,0,8025497482,931070,0,0,0,0,0,0
85.624,16527505858,8294843213,8232662645,8293852665,990548,0,0,0,0,0,0,8231707683,954962,0,0,0,0,0,0
86.631,16940042167,8501126684,8438915483,8500111544,1015140,0,0,0,0,0,0,8437936351,979132,0,0,0,0,0,0
87.639,17537733130,8790085141,8747647989,8789035538,1049603,0,0,0,0,0,0,8746633075,1014914,0,0,0,0,0,0
88.646,17971325005,9016825343,8954499662,9015748853,1076490,0,0,0,0,0,0,8953460815,1038847,0,0,0,0,0,0
89.652,18383863768,9223118783,9160744985,9222017550,1101233,0,0,0,0,0,0,9159682084,1062901,0,0,0,0,0,0
90.662,18899258985,9479401666,9419857319,9478269478,1132188,0,0,0,0,0,0,9418764433,1092886,0,0,0,0,0,0
91.669,19415177276,9738841461,9676335815,9737678535,1162926,0,0,0,0,0,0,9675213129,1122686,0,0,0,0,0,0
92.676,19827688325,9945121686,9882566639,9943934210,1187476,0,0,0,0,0,0,9881420128,1146511,0,0,0,0,0,0
93.683,20248264707,10155025579,10093239128,10153812917,1212662,0,0,0,0,0,0,10092068064,1171064,0,0,0,0,0,0
94.691,20858998656,10460824190,10398174466,10459575322,1248868,0,0,0,0,0,0,10396967904,1206562,0,0,0,0,0,0
95.698,21271509086,10667111246,10604397840,10665837732,1273514,0,0,0,0,0,0,10603167552,1230288,0,0,0,0,0,0
96.706,21684024121,10873403483,10810620638,10872105252,1298231,0,0,0,0,0,0,10809366637,1254001,0,0,0,0,0,0
97.715,22251082153,11148833710,11102248443,11147502852,1330858,0,0,0,0,0,0,11100960916,1287527,0,0,0,0,0,0
98.723,22715282047,11389092449,11326189598,11387733028,1359421,0,0,0,0,0,0,11324876126,1313472,0,0,0,0,0,0
99.731,23127790180,11595366101,11532424079,11593982217,1383884,0,0,0,0,0,0,11531086710,1337369,0,0,0,0,0,0
100.741,23627225708,11842947409,11784278299,11841534069,1413340,0,0,0,0,0,0,11782911880,1366419,0,0,0,0,0,0
101.748,24159075009,12111073176,12048001833,12109627837,1445339,0,0,0,0,0,0,12046604973,1396860,0,0,0,0,0,0
102.756,24571576207,12317337838,12254238369,12315868175,1469663,0,0,0,0,0,0,12252817597,1420772,0,0,0,0,0,0
103.763,24984101490,12523620697,12460480793,12522126434,1494263,0,0,0,0,0,0,12459036008,1444785,0,0,0,0,0,0
104.771,25602888868,12833066723,12769822145,12831535250,1531473,0,0,0,0,0,0,12768341675,1480470,0,0,0,0,0,0
105.779,26015412674,13039363015,12976049659,13037806757,1556258,0,0,0,0,0,0,12974545391,1504268,0,0,0,0,0,0
106.786,26427929969,13245643429,13182286540,13244062609,1580820,0,0,0,0,0,0,13180758343,1528197,0,0,0,0,0,0
107.794,26999970481,13520234636,13479735845,13518620875,1613761,0,0,0,0,0,0,13478173220,1562625,0,0,0,0,0,0
108.802,27459286155,13761351520,13697934635,13759709206,1642314,0,0,0,0,0,0,13696346584,1588051,0,0,0,0,0,0
109.809,27871801539,13967633174,13904168365,13965966290,1666884,0,0,0,0,0,0,13902556425,1611940,0,0,0,0,0,0
110.817,28329545792,14197656449,14131889343,14195961859,1694590,0,0,0,0,0,0,14130251020,1638323,0,0,0,0,0,0
111.824,28903124153,14483386940,14419737213,14481657902,1729038,0,0,0,0,0,0,14418065809,1671404,0,0,0,0,0,0
112.831,29315700762,14689685499,14626015263,14687931641,1753858,0,0,0,0,0,0,14624319719,1695544,0,0,0,0,0,0
113.839,29728252098,14895984402,14832267696,14894205717,1778685,0,0,0,0,0,0,14830547990,1719706,0,0,0,0,0,0
114.846,30333696227,15192105953,15141590274,15190291415,1814538,0,0,0,0,0,0,15139834415,1755859,0,0,0,0,0,0
115.854,30759598302,15411709607,15347888695,15409869163,1840444,0,0,0,0,0,0,15346108733,1779962,0,0,0,0,0,0
116.861,31172130256,15618002123,15554128133,15616136958,1865165,0,0,0,0,0,0,15552324217,1803916,0,0,0,0,0,0
117.871,31698775805,15880121686,15818654119,15878224941,1896745,0,0,0,0,0,0,15816819571,1834548,0,0,0,0,0,0
118.878,32203473579,16133753240,16069720339,16131825952,1927288,0,0,0,0,0,0,16067856598,1863741,0,0,0,0,0,0
119.884,32616015231,16340050058,16275965173,16338097966,1952092,0,0,0,0,0,0,16274077650,1887523,0,0,0,0,0,0
120.890,33028556089,16546364826,16482191263,16544387662,1977164,0,0,0,0,0,0,16480279981,1911282,0,0,0,0,0,0
121.899,33644392986,16852899124,16791493862,16850885245,2013879,0,0,0,0,0,0,16789546864,1946998,0,0,0,0,0,0
122.906,34059883187,17062099066,16997784121,17060060035,2039031,0,0,0,0,0,0,16995813013,1971108,0,0,0,0,0,0
123.912,34472421616,17268403720,17204017896,17266339787,2063933,0,0,0,0,0,0,17202022905,1994991,0,0,0,0,0,0
124.920,34990140757,17520708708,17469432049,17518614613,2094095,0,0,0,0,0,0,17467406531,2025518,0,0,0,0,0,0
125.928,35503694896,17784105622,17719589274,17781980278,2125344,0,0,0,0,0,0,17717534767,2054507,0,0,0,0,0,0
126.936,35916226413,17990403831,17925822582,17988253667,2150164,0,0,0,0,0,0,17923744214,2078368,0,0,0,0,0,0
127.943,36328739841,18196678992,18132060849,18194504351,2174641,0,0,0,0,0,0,18129958536,2102313,0,0,0,0,0,0
128.950,36947552262,18506116185,18441436077,18503904470,2211715,0,0,0,0,0,0,18439297572,2138505,0,0,0,0,0,0
129.957,37360084506,18712419631,18647664875,18710183008,2236623,0,0,0,0,0,0,18645502561,2162314,0,0,0,0,0,0
130.963,37772667243,18918714357,18853952886,18916452958,2261399,0,0,0,0,0,0,18851766285,2186601,0,0,0,0,0,0
131.971,38317445185,19177127001,19140318184,19174834382,2292619,0,0,0,0,0,0,19138098820,2219364,0,0,0,0,0,0
132.979,38803969502,19434449680,19369519822,19432126368,2323312,0,0,0,0,0,0,19367273768,2246054,0,0,0,0,0,0
133.987,39216490524,19640729220,19575761304,19638381361,2347859,0,0,0,0,0,0,19573491244,2270060,0,0,0,0,0,0
134.995,39645227638,19855234081,19789993557,19852860533,2373548,0,0,0,0,0,0,19787698703,2294854,0,0,0,0,0,0
136.002,40247790053,20156451921,20091338132,20154042343,2409578,0,0,0,0,0,0,20089008467,2329665,0,0,0,0,0,0
137.009,40660324286,20362740546,20297583740,20360306293,2434253,0,0,0,0,0,0,20295230007,2353733,0,0,0,0,0,0
138.016,41072848218,20569032620,20503815598,20566573633,2458987,0,0,0,0,0,0,20501438011,2377587,0,0,0,0,0,0
139.024,41668595981,20855947018,20812648963,20853453644,2493374,0,0,0,0,0,0,20810235733,2413230,0,0,0,0,0,0
140.031,42104150869,21084753878,21019396991,21082233206,2520672,0,0,0,0,0,0,21016959747,2437244,0,0,0,0,0,0
141.038,42516667736,21291040262,21225627474,21288494944,2545318,0,0,0,0,0,0,21223166394,2461080,0,0,0,0,0,0
142.046,42970203184,21518571761,21451631423,21515999204,2572557,0,0,0,0,0,0,21449144049,2487374,0,0,0,0,0,0
143.053,43547922814,21806708646,21741214168,21804101820,2606826,0,0,0,0,0,0,21738693278,2520890,0,0,0,0,0,0
144.060,43547926957,21806710495,21741216462,21804103648,2606847,0,0,0,0,0,0,21738695549,2520913,0,0,0,0,0,0
