time(sec),sum-all,sum-rcv,sum-trans,rcv-bytes,rcv-packets,rcv-errs,rcv-drop,rcv-fifo,rcv-frame,rcv-compressed,rcv-multicast,trans-bytes,trans-packets,trans-errs,trans-drop,trans-fifo,trans-colls,trans-carrier,trans-compressed
0.000,0,0,0,0,0,0,0,0,0,0,0,0,0,0,0,0,0,0,0
1.007,86,43,43,42,1,0,0,0,0,0,0,42,1,0,0,0,0,0,0
2.014,4305,428,3877,420,8,0,0,0,0,0,0,3862,15,0,0,0,0,0,0
3.021,5915,636,5279,624,12,0,0,0,0,0,0,5258,21,0,0,0,0,0,0
4.028,11997,947,11050,930,17,0,0,0,0,0,0,11020,30,0,0,0,0,0,0
5.035,16365,1330,15035,1308,22,0,0,0,0,0,0,14998,37,0,0,0,0,0,0
6.041,16365,1330,15035,1308,22,0,0,0,0,0,0,14998,37,0,0,0,0,0,0
7.049,16365,1330,15035,1308,22,0,0,0,0,0,0,14998,37,0,0,0,0,0,0
8.056,18538,1476,17062,1452,24,0,0,0,0,0,0,17020,42,0,0,0,0,0,0
9.062,18538,1476,17062,1452,24,0,0,0,0,0,0,17020,42,0,0,0,0,0,0
10.069,18538,1476,17062,1452,24,0,0,0,0,0,0,17020,42,0,0,0,0,0,0
11.075,18538,1476,17062,1452,24,0,0,0,0,0,0,17020,42,0,0,0,0,0,0
12.081,18538,1476,17062,1452,24,0,0,0,0,0,0,17020,42,0,0,0,0,0,0
13.088,18538,1476,17062,1452,24,0,0,0,0,0,0,17020,42,0,0,0,0,0,0
14.094,18538,1476,17062,1452,24,0,0,0,0,0,0,17020,42,0,0,0,0,0,0
15.101,18538,1476,17062,1452,24,0,0,0,0,0,0,17020,42,0,0,0,0,0,0
16.107,18538,1476,17062,1452,24,0,0,0,0,0,0,17020,42,0,0,0,0,0,0
17.114,25187,4139,21048,4095,44,0,0,0,0,0,0,20986,62,0,0,0,0,0,0
18.120,143280,97100,46180,97019,81,0,0,0,0,0,0,46095,85,0,0,0,0,0,0
19.126,143280,97100,46180,97019,81,0,0,0,0,0,0,46095,85,0,0,0,0,0,0
20.133,267038,217323,49715,217214,109,0,0,0,0,0,0,49614,101,0,0,0,0,0,0
21.140,313725,262187,51538,262012,175,0,0,0,0,0,0,51411,127,0,0,0,0,0,0
22.147,313725,262187,51538,262012,175,0,0,0,0,0,0,51411,127,0,0,0,0,0,0
23.154,145893330,42795039,103098291,42789825,5214,0,0,0,0,0,0,103086572,11719,0,0,0,0,0,0
24.161,145900713,42799013,103101700,42793779,5234,0,0,0,0,0,0,103089957,11743,0,0,0,0,0,0
25.168,188608585,42854727,145753858,42849069,5658,0,0,0,0,0,0,145737303,16555,0,0,0,0,0,0
26.175,188608585,42854727,145753858,42849069,5658,0,0,0,0,0,0,145737303,16555,0,0,0,0,0,0
27.181,188608585,42854727,145753858,42849069,5658,0,0,0,0,0,0,145737303,16555,0,0,0,0,0,0
28.187,188663152,42856644,145806508,42850977,5667,0,0,0,0,0,0,145789940,16568,0,0,0,0,0,0
29.194,188663152,42856644,145806508,42850977,5667,0,0,0,0,0,0,145789940,16568,0,0,0,0,0,0
30.200,188663152,42856644,145806508,42850977,5667,0,0,0,0,0,0,145789940,16568,0,0,0,0,0,0
31.207,231205758,85368902,145836856,85358501,10401,0,0,0,0,0,0,145820186,16670,0,0,0,0,0,0
32.214,232370240,86087900,146282340,86077264,10636,0,0,0,0,0,0,146265532,16808,0,0,0,0,0,0
33.222,232376323,86091995,146284328,86081336,10659,0,0,0,0,0,0,146267502,16826,0,0,0,0,0,0
34.229,232376323,86091995,146284328,86081336,10659,0,0,0,0,0,0,146267502,16826,0,0,0,0,0,0
35.236,232376323,86091995,146284328,86081336,10659,0,0,0,0,0,0,146267502,16826,0,0,0,0,0,0
36.243,232376323,86091995,146284328,86081336,10659,0,0,0,0,0,0,146267502,16826,0,0,0,0,0,0
37.250,232376323,86091995,146284328,86081336,10659,0,0,0,0,0,0,146267502,16826,0,0,0,0,0,0
38.257,232593166,86092566,146500600,86081900,10666,0,0,0,0,0,0,146483747,16853,0,0,0,0,0,0
39.264,232899964,86354722,146545242,86343996,10726,0,0,0,0,0,0,146528350,16892,0,0,0,0,0,0
40.271,232899964,86354722,146545242,86343996,10726,0,0,0,0,0,0,146528350,16892,0,0,0,0,0,0
41.279,232899964,86354722,146545242,86343996,10726,0,0,0,0,0,0,146528350,16892,0,0,0,0,0,0
42.287,253678356,94624488,159053868,94612794,11694,0,0,0,0,0,0,159035498,18370,0,0,0,0,0,0
43.294,439048872,189399514,249649358,189376747,22767,0,0,0,0,0,0,249620090,29268,0,0,0,0,0,0
44.302,851690244,395725387,455964857,395678576,46811,0,0,0,0,0,0,455911157,53700,0,0,0,0,0,0
45.309,1264211355,601961423,662249932,601890703,70720,0,0,0,0,0,0,662171608,78324,0,0,0,0,0,0
46.317,1802712848,876811964,925900884,876709175,102789,0,0,0,0,0,0,925791249,109635,0,0,0,0,0,0
47.323,2295540518,1117566314,1177974204,1117435594,130720,0,0,0,0,0,0,1177834687,139517,0,0,0,0,0,0
48.331,2708068434,1323801847,1384266587,1323647221,154626,0,0,0,0,0,0,1384102334,164253,0,0,0,0,0,0
49.338,3120591722,1530028798,1590562924,1529850393,178405,0,0,0,0,0,0,1590373869,189055,0,0,0,0,0,0
50.346,3739366089,1839383639,1899982450,1839169349,214290,0,0,0,0,0,0,1899756573,225877,0,0,0,0,0,0
51.353,4151890783,2045622339,2106268444,2045384092,238247,0,0,0,0,0,0,2106017922,250522,0,0,0,0,0,0
52.361,4564417263,2251857714,2312559549,2251595558,262156,0,0,0,0,0,0,2312284305,275244,0,0,0,0,0,0
53.370,5139043956,2543987336,2595056620,2543691254,296082,0,0,0,0,0,0,2594747528,309092,0,0,0,0,0,0
54.377,5595768235,2767466681,2828301554,2767144442,322239,0,0,0,0,0,0,2827964425,337129,0,0,0,0,0,0
55.384,6008298413,2973728422,3034569991,2973381892,346530,0,0,0,0,0,0,3034208477,361514,0,0,0,0,0,0
56.391,6426356584,3183203301,3243153283,3182832477,370824,0,0,0,0,0,0,3242766664,386619,0,0,0,0,0,0
57.399,7039617302,3489320780,3550296522,3488914436,406344,0,0,0,0,0,0,3549873231,423291,0,0,0,0,0,0
58.405,7452126014,3695549207,3756576807,3695119069,430138,0,0,0,0,0,0,3756128953,447854,0,0,0,0,0,0
59.412,7864642281,3901784441,3962857840,3901330401,454040,0,0,0,0,0,0,3962385414,472426,0,0,0,0,0,0
60.422,8414664479,4182264310,4232400169,4181777872,486438,0,0,0,0,0,0,4231895185,504984,0,0,0,0,0,0
61.427,8895956693,4417355512,4478601181,4416841982,513530,0,0,0,0,0,0,4478066733,534448,0,0,0,0,0,0
62.434,9308474971,4623580120,4684894851,4623042847,537273,0,0,0,0,0,0,4684335644,559207,0,0,0,0,0,0
63.442,9720978553,4829818902,4891159651,4829257675,561227,0,0,0,0,0,0,4890576111,583540,0,0,0,0,0,0
64.449,10339666618,5139124465,5200542153,5138527465,597000,0,0,0,0,0,0,5199921706,620447,0,0,0,0,0,0
65.456,10752281746,5345398604,5406883142,5344777735,620869,0,0,0,0,0,0,5406237856,645286,0,0,0,0,0,0
66.463,11164775303,5551619421,5613155882,5550974861,644560,0,0,0,0,0,0,5612486152,669730,0,0,0,0,0,0
67.473,11667938463,5804326459,5863612004,5803652917,673542,0,0,0,0,0,0,5862912130,699874,0,0,0,0,0,0
68.481,12196120997,6067201740,6128919257,6066497501,704239,0,0,0,0,0,0,6128187197,732060,0,0,0,0,0,0
69.488,12608649238,6273439731,6335209507,6272711541,728190,0,0,0,0,0,0,6334452737,756770,0,0,0,0,0,0
70.496,13024750789,6482488490,6542262299,6481735931,752559,0,0,0,0,0,0,6541480812,781487,0,0,0,0,0,0
71.504,13639931704,6789023913,6850907791,6788236017,787896,0,0,0,0,0,0,6850089656,818135,0,0,0,0,0,0
72.511,14052442007,6995255693,7057186314,6994443959,811734,0,0,0,0,0,0,7056343642,842672,0,0,0,0,0,0
73.519,14464950561,7201480055,7263470506,7200644579,835476,0,0,0,0,0,0,7262603214,867292,0,0,0,0,0,0
74.528,14995715431,7467906729,7527808702,7467040543,866186,0,0,0,0,0,0,7526909763,898939,0,0,0,0,0,0
75.535,15496306972,7717056328,7779250644,7716161259,895069,0,0,0,0,0,0,7778321461,929183,0,0,0,0,0,0
76.543,15908824192,7923296387,7985527805,7922377338,919049,0,0,0,0,0,0,7984574118,953687,0,0,0,0,0,0
77.550,16341960805,8142460440,8199500365,8141516051,944389,0,0,0,0,0,0,8198521279,979086,0,0,0,0,0,0
78.557,16940141693,8438904333,8501237360,8437925217,979116,0,0,0,0,0,0,8500222174,1015186,0,0,0,0,0,0
79.564,17352664333,8645146363,8707517970,8644143235,1003128,0,0,0,0,0,0,8706478222,1039748,0,0,0,0,0,0
80.571,17765184590,8851379903,8913804687,8850352895,1027008,0,0,0,0,0,0,8912740298,1064389,0,0,0,0,0,0
81.581,18372907087,9160681993,9212225094,9159619210,1062783,0,0,0,0,0,0,9211125094,1100000,0,0,0,0,0,0
82.588,18796536835,9366966220,9429570615,9365879482,1086738,0,0,0,0,0,0,9428444287,1126328,0,0,0,0,0,0
83.596,19209052293,9573202586,9635849707,9572091939,1110647,0,0,0,0,0,0,9634698846,1150861,0,0,0,0,0,0
84.605,19715362906,9836432483,9878930423,9835291447,1141036,0,0,0,0,0,0,9877750619,1179804,0,0,0,0,0,0
85.613,20240354594,10088800225,10151554369,10087629688,1170537,0,0,0,0,0,0,10150342078,1212291,0,0,0,0,0,0
86.620,20652875256,10295043824,10357831432,10293849252,1194572,0,0,0,0,0,0,10356594647,1236785,0,0,0,0,0,0
87.626,21065379013,10501275074,10564103939,10500056656,1218418,0,0,0,0,0,0,10562842727,1261212,0,0,0,0,0,0
88.635,21684150216,10810608671,10873541545,10809354690,1253981,0,0,0,0,0,0,10872243265,1298280,0,0,0,0,0,0
89.641,22096636878,11016834329,11079802549,11015556589,1277740,0,0,0,0,0,0,11078480014,1322535,0,0,0,0,0,0
90.648,22509142686,11223057800,11286084886,11221756335,1301465,0,0,0,0,0,0,11284737773,1347113,0,0,0,0,0,0
91.657,23085884664,11520968107,11564916557,11519632177,1335930,0,0,0,0,0,0,11563536134,1380423,0,0,0,0,0,0
92.667,23540432364,11738643209,11801789155,11737282005,1361204,0,0,0,0,0,0,11800380618,1408537,0,0,0,0,0,0
93.674,23952937482,11944871763,12008065719,11943486751,1385012,0,0,0,0,0,0,12006632690,1433029,0,0,0,0,0,0
94.685,24475591272,12205519680,12270071592,12204104529,1415151,0,0,0,0,0,0,12268607581,1464011,0,0,0,0,0,0
95.693,24984219166,12460459541,12523759625,12459014775,1444766,0,0,0,0,0,0,12522265309,1494316,0,0,0,0,0,0
96.700,25396745678,12666687542,12730058136,12665218981,1468561,0,0,0,0,0,0,12728538990,1519146,0,0,0,0,0,0
97.707,25809258254,12872913566,12936344688,12871421235,1492331,0,0,0,0,0,0,12934800911,1543777,0,0,0,0,0,0
98.716,26428047377,13182265154,13245782223,13180736978,1528176,0,0,0,0,0,0,13244201352,1580871,0,0,0,0,0,0
99.723,26840575592,13388504836,13452070756,13386952696,1552140,0,0,0,0,0,0,13450465206,1605550,0,0,0,0,0,0
100.730,27253095788,13594740270,13658355518,13593164217,1576053,0,0,0,0,0,0,13656725352,1630166,0,0,0,0,0,0
101.739,27825822298,13889369858,13936452440,13887759790,1610068,0,0,0,0,0,0,13934789200,1663240,0,0,0,0,0,0
102.746,28284410774,14110327883,14174082891,14108692082,1635801,0,0,0,0,0,0,14172390959,1691932,0,0,0,0,0,0
103.754,28696925459,14316550429,14380375030,14314890909,1659520,0,0,0,0,0,0,14378658376,1716654,0,0,0,0,0,0
104.762,29140278070,14534984609,14605293461,14533299748,1684861,0,0,0,0,0,0,14603549821,1743640,0,0,0,0,0,0
105.769,29728315410,14832164493,14896150917,14830444820,1719673,0,0,0,0,0,0,14894372175,1778742,0,0,0,0,0,0
106.777,30140869818,15038419030,15102450788,15036675160,1743870,0,0,0,0,0,0,15100647199,1803589,0,0,0,0,0,0
107.784,30553421716,15244661102,15308760614,15242893225,1767877,0,0,0,0,0,0,15306932026,1828588,0,0,0,0,0,0
108.792,31167766438,15553972745,15613793693,15552168937,1803808,0,0,0,0,0,0,15611929040,1864653,0,0,0,0,0,0
109.799,31584738227,15760263599,15824474628,15758435755,1827844,0,0,0,0,0,0,15822584477,1890151,0,0,0,0,0,0
110.806,31997265209,15966489947,16030775262,15964638334,1851613,0,0,0,0,0,0,16028860265,1914997,0,0,0,0,0,0
111.816,32521361594,16231603761,16289757833,16229721377,1882384,0,0,0,0,0,0,16287811708,1946125,0,0,0,0,0,0
112.823,33028610452,16482069792,16546540660,16480158545,1911247,0,0,0,0,0,0,16544563437,1977223,0,0,0,0,0,0
113.831,33441151782,16688303334,16752848448,16686368219,1935115,0,0,0,0,0,0,16750846267,2002181,0,0,0,0,0,0
114.837,33853672596,16894540614,16959131982,16892581561,1959053,0,0,0,0,0,0,16957105211,2026771,0,0,0,0,0,0
115.845,34471781484,17203848711,17267932773,17201853842,1994869,0,0,0,0,0,0,17265868940,2063833,0,0,0,0,0,0
116.853,34884989799,17410123010,17474866789,17408104274,2018736,0,0,0,0,0,0,17472778144,2088645,0,0,0,0,0,0
117.859,35297499635,17616346512,17681153123,17614304042,2042470,0,0,0,0,0,0,17679039832,2113291,0,0,0,0,0,0
118.867,35808138115,17878137350,17930000765,17876064535,2072815,0,0,0,0,0,0,17927857822,2142943,0,0,0,0,0,0
119.875,36328794405,18131938906,18196855499,18129836628,2102278,0,0,0,0,0,0,18194680796,2174703,0,0,0,0,0,0
120.880,36741338186,18338189119,18403149067,18336062715,2126404,0,0,0,0,0,0,18400949615,2199452,0,0,0,0,0,0
121.887,37153880613,18544429970,18609450643,18542279570,2150400,0,0,0,0,0,0,18607226322,2224321,0,0,0,0,0,0
122.895,37772721606,18853803458,18918918148,18851616898,2186560,0,0,0,0,0,0,18916656684,2261464,0,0,0,0,0,0
123.902,38185225054,19060024534,19125200520,19057814278,2210256,0,0,0,0,0,0,19122914468,2286052,0,0,0,0,0,0
124.910,38597749841,19266245940,19331503901,19264011986,2233954,0,0,0,0,0,0,19329192940,2310961,0,0,0,0,0,0
125.920,39140567634,19539200517,19601367117,19536934740,2265777,0,0,0,0,0,0,19599023990,2343127,0,0,0,0,0,0
126.927,39629072812,19781845254,19847227558,19779551355,2293899,0,0,0,0,0,0,19844854866,2372692,0,0,0,0,0,0
127.934,40041579539,19988070552,20053508987,19985752892,2317660,0,0,0,0,0,0,20051111728,2397259,0,0,0,0,0,0
128.944,40489560639,20212310283,20277250356,20209966534,2343749,0,0,0,0,0,0,20274826331,2424025,0,0,0,0,0,0
129.952,41072902547,20503665917,20569236630,20501288371,2377546,0,0,0,0,0,0,20566777578,2459052,0,0,0,0,0,0
130.959,41485420591,20709907668,20775512923,20707506126,2401542,0,0,0,0,0,0,20773029375,2483548,0,0,0,0,0,0
131.967,41897952347,20916132090,20981820257,20913706805,2425285,0,0,0,0,0,0,20979311754,2508503,0,0,0,0,0,0
132.976,42481575486,21221226797,21260348689,21218766363,2460434,0,0,0,0,0,0,21257806814,2541875,0,0,0,0,0,0
133.983,42929288192,21431717733,21497570459,21429232718,2485015,0,0,0,0,0,0,21495000247,2570212,0,0,0,0,0,0
134.989,43341803258,21637959387,21703843871,21635450375,2509012,0,0,0,0,0,0,21701249221,2594650,0,0,0,0,0,0
135.996,43547971067,21741029196,21806941871,21738508340,2520856,0,0,0,0,0,0,21804334961,2606910,0,0,0,0,0,0
