time(sec),sum-all,sum-rcv,sum-trans,rcv-bytes,rcv-packets,rcv-errs,rcv-drop,rcv-fifo,rcv-frame,rcv-compressed,rcv-multicast,trans-bytes,trans-packets,trans-errs,trans-drop,trans-fifo,trans-colls,trans-carrier,trans-compressed
0.000,0,0,0,0,0,0,0,0,0,0,0,0,0,0,0,0,0,0,0
0.207,0,0,0,0,0,0,0,0,0,0,0,0,0,0,0,0,0,0,0
0.412,0,0,0,0,0,0,0,0,0,0,0,0,0,0,0,0,0,0,0
0.619,0,0,0,0,0,0,0,0,0,0,0,0,0,0,0,0,0,0,0
0.837,0,0,0,0,0,0,0,0,0,0,0,0,0,0,0,0,0,0,0
1.043,0,0,0,0,0,0,0,0,0,0,0,0,0,0,0,0,0,0,0
1.249,0,0,0,0,0,0,0,0,0,0,0,0,0,0,0,0,0,0,0
1.456,0,0,0,0,0,0,0,0,0,0,0,0,0,0,0,0,0,0,0
1.662,1018,110,908,108,2,0,0,0,0,0,0,904,4,0,0,0,0,0,0
1.869,1751,165,1586,162,3,0,0,0,0,0,0,1580,6,0,0,0,0,0,0
2.075,4451,330,4121,324,6,0,0,0,0,0,0,4110,11,0,0,0,0,0,0
2.281,4451,330,4121,324,6,0,0,0,0,0,0,4110,11,0,0,0,0,0,0
2.487,4451,330,4121,324,6,0,0,0,0,0,0,4110,11,0,0,0,0,0,0
2.694,4451,330,4121,324,6,0,0,0,0,0,0,4110,11,0,0,0,0,0,0
2.900,4451,330,4121,324,6,0,0,0,0,0,0,4110,11,0,0,0,0,0,0
3.106,4451,330,4121,324,6,0,0,0,0,0,0,4110,11,0,0,0,0,0,0
3.312,4451,330,4121,324,6,0,0,0,0,0,0,4110,11,0,0,0,0,0,0
3.518,4451,330,4121,324,6,0,0,0,0,0,0,4110,11,0,0,0,0,0,0
3.724,4451,330,4121,324,6,0,0,0,0,0,0,4110,11,0,0,0,0,0,0
3.929,4451,330,4121,324,6,0,0,0,0,0,0,4110,11,0,0,0,0,0,0
4.135,4451,330,4121,324,6,0,0,0,0,0,0,4110,11,0,0,0,0,0,0
4.341,4451,330,4121,324,6,0,0,0,0,0,0,4110,11,0,0,0,0,0,0
4.547,4451,330,4121,324,6,0,0,0,0,0,0,4110,11,0,0,0,0,0,0
4.753,4451,330,4121,324,6,0,0,0,0,0,0,4110,11,0,0,0,0,0,0
4.959,4451,330,4121,324,6,0,0,0,0,0,0,4110,11,0,0,0,0,0,0
5.165,9468,2926,6542,2901,25,0,0,0,0,0,0,6512,30,0,0,0,0,0,0
5.371,9468,2926,6542,2901,25,0,0,0,0,0,0,6512,30,0,0,0,0,0,0
5.578,160164,128606,31558,128520,86,0,0,0,0,0,0,31490,68,0,0,0,0,0,0
5.784,42603374,42558743,44631,42553933,4810,0,0,0,0,0,0,44376,255,0,0,0,0,0,0
5.991,42710256,42659032,51224,42654147,4885,0,0,0,0,0,0,50939,285,0,0,0,0,0,0
6.197,42710256,42659032,51224,42654147,4885,0,0,0,0,0,0,50939,285,0,0,0,0,0,0
6.403,42710256,42659032,51224,42654147,4885,0,0,0,0,0,0,50939,285,0,0,0,0,0,0
6.609,42710256,42659032,51224,42654147,4885,0,0,0,0,0,0,50939,285,0,0,0,0,0,0
6.815,42760402,42708875,51527,42703982,4893,0,0,0,0,0,0,51239,288,0,0,0,0,0,0
7.021,49457396,42743997,6713399,42738937,5060,0,0,0,0,0,0,6712312,1087,0,0,0,0,0,0
7.228,85372659,42792142,42580517,42786367,5775,0,0,0,0,0,0,42575244,5273,0,0,0,0,0,0
7.434,85372726,42792142,42580584,42786367,5775,0,0,0,0,0,0,42575310,5274,0,0,0,0,0,0
7.640,85372726,42792142,42580584,42786367,5775,0,0,0,0,0,0,42575310,5274,0,0,0,0,0,0
7.847,85372726,42792142,42580584,42786367,5775,0,0,0,0,0,0,42575310,5274,0,0,0,0,0,0
8.053,85374366,42792197,42582169,42786421,5776,0,0,0,0,0,0,42576892,5277,0,0,0,0,0,0
8.259,85374366,42792197,42582169,42786421,5776,0,0,0,0,0,0,42576892,5277,0,0,0,0,0,0
8.466,85374366,42792197,42582169,42786421,5776,0,0,0,0,0,0,42576892,5277,0,0,0,0,0,0
8.672,85374366,42792197,42582169,42786421,5776,0,0,0,0,0,0,42576892,5277,0,0,0,0,0,0
8.878,85374366,42792197,42582169,42786421,5776,0,0,0,0,0,0,42576892,5277,0,0,0,0,0,0
9.085,85374366,42792197,42582169,42786421,5776,0,0,0,0,0,0,42576892,5277,0,0,0,0,0,0
9.291,85374366,42792197,42582169,42786421,5776,0,0,0,0,0,0,42576892,5277,0,0,0,0,0,0
9.497,85379525,42794270,42585255,42788479,5791,0,0,0,0,0,0,42579958,5297,0,0,0,0,0,0
9.704,85500672,42820801,42679871,42814966,5835,0,0,0,0,0,0,42674516,5355,0,0,0,0,0,0
9.910,85500672,42820801,42679871,42814966,5835,0,0,0,0,0,0,42674516,5355,0,0,0,0,0,0
10.116,85500672,42820801,42679871,42814966,5835,0,0,0,0,0,0,42674516,5355,0,0,0,0,0,0
10.323,85618790,42821184,42797606,42815345,5839,0,0,0,0,0,0,42792235,5371,0,0,0,0,0,0
10.529,85677635,42827144,42850491,42821233,5911,0,0,0,0,0,0,42844957,5534,0,0,0,0,0,0
10.735,231260767,145876270,85384497,145858735,17535,0,0,0,0,0,0,85373915,10582,0,0,0,0,0,0
10.941,231260834,145876337,85384497,145858801,17536,0,0,0,0,0,0,85373915,10582,0,0,0,0,0,0
11.147,231487152,145876786,85610366,145859244,17542,0,0,0,0,0,0,85599756,10610,0,0,0,0,0,0
11.354,231747243,146098588,85648655,146080748,17840,0,0,0,0,0,0,85637853,10802,0,0,0,0,0,0
11.560,231749710,146099208,85650502,146081362,17846,0,0,0,0,0,0,85639691,10811,0,0,0,0,0,0
11.766,231749710,146099208,85650502,146081362,17846,0,0,0,0,0,0,85639691,10811,0,0,0,0,0,0
11.973,231749710,146099208,85650502,146081362,17846,0,0,0,0,0,0,85639691,10811,0,0,0,0,0,0
12.179,231749710,146099208,85650502,146081362,17846,0,0,0,0,0,0,85639691,10811,0,0,0,0,0,0
12.385,231749710,146099208,85650502,146081362,17846,0,0,0,0,0,0,85639691,10811,0,0,0,0,0,0
12.591,231749710,146099208,85650502,146081362,17846,0,0,0,0,0,0,85639691,10811,0,0,0,0,0,0
12.798,231749710,146099208,85650502,146081362,17846,0,0,0,0,0,0,85639691,10811,0,0,0,0,0,0
13.004,231749710,146099208,85650502,146081362,17846,0,0,0,0,0,0,85639691,10811,0,0,0,0,0,0
13.210,231749710,146099208,85650502,146081362,17846,0,0,0,0,0,0,85639691,10811,0,0,0,0,0,0
13.417,231749710,146099208,85650502,146081362,17846,0,0,0,0,0,0,85639691,10811,0,0,0,0,0,0
13.623,231749710,146099208,85650502,146081362,17846,0,0,0,0,0,0,85639691,10811,0,0,0,0,0,0
13.831,231749710,146099208,85650502,146081362,17846,0,0,0,0,0,0,85639691,10811,0,0,0,0,0,0
14.037,231749710,146099208,85650502,146081362,17846,0,0,0,0,0,0,85639691,10811,0,0,0,0,0,0
14.243,232022901,146126639,85896262,146108725,17914,0,0,0,0,0,0,85885379,10883,0,0,0,0,0,0
14.450,232022901,146126639,85896262,146108725,17914,0,0,0,0,0,0,85885379,10883,0,0,0,0,0,0
14.658,232244604,146347797,85896807,146329854,17943,0,0,0,0,0,0,85885918,10889,0,0,0,0,0,0
14.865,232244860,146347864,85896996,146329920,17944,0,0,0,0,0,0,85886105,10891,0,0,0,0,0,0
15.073,232298899,146373629,85925270,146355616,18013,0,0,0,0,0,0,85914284,10986,0,0,0,0,0,0
15.279,232299275,146373775,85925500,146355760,18015,0,0,0,0,0,0,85914512,10988,0,0,0,0,0,0
15.485,232299275,146373775,85925500,146355760,18015,0,0,0,0,0,0,85914512,10988,0,0,0,0,0,0
15.692,240569688,146380376,94189312,146362265,18111,0,0,0,0,0,0,94177380,11932,0,0,0,0,0,0
15.899,250092079,146383267,103708812,146365116,18151,0,0,0,0,0,0,103695816,12996,0,0,0,0,0,0
16.105,271725514,146387082,125338432,146368879,18203,0,0,0,0,0,0,125323027,15405,0,0,0,0,0,0
16.313,282255525,146389973,135865552,146371729,18244,0,0,0,0,0,0,135848964,16588,0,0,0,0,0,0
16.520,289811811,146393711,143418100,146375413,18298,0,0,0,0,0,0,143400645,17455,0,0,0,0,0,0
16.726,309095920,158909011,150186909,158889237,19774,0,0,0,0,0,0,150168599,18310,0,0,0,0,0,0
16.937,335210038,180629355,154580683,180607115,22240,0,0,0,0,0,0,154561786,18897,0,0,0,0,0,0
17.143,390326105,218438036,171888069,218411477,26559,0,0,0,0,0,0,171867115,20954,0,0,0,0,0,0
17.350,430096339,243621981,186474358,243592499,29482,0,0,0,0,0,0,186451588,22770,0,0,0,0,0,0
17.556,436901805,248418531,188483274,248388429,30102,0,0,0,0,0,0,188460189,23085,0,0,0,0,0,0
17.763,437459087,248772609,188686478,248742446,30163,0,0,0,0,0,0,188663349,23129,0,0,0,0,0,0
17.969,438620174,249530071,189090103,249499601,30470,0,0,0,0,0,0,189066732,23371,0,0,0,0,0,0
18.189,481874430,265653001,216221429,265620644,32357,0,0,0,0,0,0,216195006,26423,0,0,0,0,0,0
18.401,625862683,343444530,282418153,343403297,41233,0,0,0,0,0,0,282384055,34098,0,0,0,0,0,0
18.609,644890317,352661871,292228446,352619301,42570,0,0,0,0,0,0,292192908,35538,0,0,0,0,0,0
18.824,681055268,365101088,315954180,365057092,43996,0,0,0,0,0,0,315915956,38224,0,0,0,0,0,0
19.039,766217590,416391314,349826276,416341548,49766,0,0,0,0,0,0,349784091,42185,0,0,0,0,0,0
19.246,851046116,455726089,395320027,455671746,54343,0,0,0,0,0,0,395272473,47554,0,0,0,0,0,0
19.454,851149931,455777251,395372680,455722807,54444,0,0,0,0,0,0,395324998,47682,0,0,0,0,0,0
19.663,965760511,504632172,461128339,504572064,60108,0,0,0,0,0,0,461073101,55238,0,0,0,0,0,0
19.876,1057130850,558692910,498437940,558626594,66316,0,0,0,0,0,0,498378276,59664,0,0,0,0,0,0
20.084,1057515055,558963559,498551496,558897110,66449,0,0,0,0,0,0,498491664,59832,0,0,0,0,0,0
20.295,1165649709,607224633,558425076,607152625,72008,0,0,0,0,0,0,558358388,66688,0,0,0,0,0,0
20.503,1258018256,659226449,598791807,659148453,77996,0,0,0,0,0,0,598720429,71378,0,0,0,0,0,0
20.711,1263776385,662093681,601682704,662015133,78548,0,0,0,0,0,0,601610770,71934,0,0,0,0,0,0
20.919,1353579905,695462599,658117306,695380166,82433,0,0,0,0,0,0,658038865,78441,0,0,0,0,0,0
21.126,1464052167,762002604,702049563,761912580,90024,0,0,0,0,0,0,701965883,83680,0,0,0,0,0,0
21.333,1470223464,765220202,705003262,765129608,90594,0,0,0,0,0,0,704919044,84218,0,0,0,0,0,0
21.544,1557363553,795143735,762219818,795049707,94028,0,0,0,0,0,0,762129122,90696,0,0,0,0,0,0
21.760,1663090873,857920925,805169948,857819734,101191,0,0,0,0,0,0,805074276,95672,0,0,0,0,0,0
21.967,1676472472,868342639,808129833,868240056,102583,0,0,0,0,0,0,808033573,96260,0,0,0,0,0,0
22.177,1741186942,903268543,837918399,903162017,106526,0,0,0,0,0,0,837818710,99689,0,0,0,0,0,0
22.400,1853497538,957341004,896156534,957228299,112705,0,0,0,0,0,0,896050240,106294,0,0,0,0,0,0
22.606,1882894968,971647476,911247492,971532991,114485,0,0,0,0,0,0,911139317,108175,0,0,0,0,0,0
22.818,1920939481,989657257,931282224,989540732,116525,0,0,0,0,0,0,931171758,110466,0,0,0,0,0,0
23.039,2033026356,1025717064,1007309292,1025596286,120778,0,0,0,0,0,0,1007190141,119151,0,0,0,0,0,0
23.247,2089151959,1074770418,1014381541,1074643937,126481,0,0,0,0,0,0,1014261206,120335,0,0,0,0,0,0
23.457,2115560295,1083253057,1032307238,1083125594,127463,0,0,0,0,0,0,1032184875,122363,0,0,0,0,0,0
23.667,2206174345,1119548173,1086626172,1119416460,131713,0,0,0,0,0,0,1086497487,128685,0,0,0,0,0,0
23.876,2295307181,1177840716,1117466465,1177702365,138351,0,0,0,0,0,0,1117334108,132357,0,0,0,0,0,0
24.083,2295411417,1177892235,1117519182,1177753773,138462,0,0,0,0,0,0,1117386694,132488,0,0,0,0,0,0
24.294,2397468360,1218480084,1178988276,1218336932,143152,0,0,0,0,0,0,1178848745,139531,0,0,0,0,0,0
24.505,2496918369,1277926063,1218992306,1277776151,149912,0,0,0,0,0,0,1218847974,144332,0,0,0,0,0,0
24.712,2501677762,1281013814,1220663948,1280863384,150430,0,0,0,0,0,0,1220519263,144685,0,0,0,0,0,0
24.921,2598903831,1316511537,1282392294,1316357019,154518,0,0,0,0,0,0,1282240578,151716,0,0,0,0,0,0
25.129,2703629631,1381193042,1322436589,1381031127,161915,0,0,0,0,0,0,1322280184,156405,0,0,0,0,0,0
25.335,2707928061,1384137407,1323790654,1383974987,162420,0,0,0,0,0,0,1323633910,156744,0,0,0,0,0,0
25.544,2803857062,1423407007,1380450055,1423240091,166916,0,0,0,0,0,0,1380286881,163174,0,0,0,0,0,0
25.759,2908182139,1483624010,1424558129,1483450212,173798,0,0,0,0,0,0,1424389813,168316,0,0,0,0,0,0
25.966,2914191205,1487266101,1426925104,1487091625,174476,0,0,0,0,0,0,1426756220,168884,0,0,0,0,0,0
26.180,2982250341,1514793800,1467456541,1514616169,177631,0,0,0,0,0,0,1467283079,173462,0,0,0,0,0,0
26.395,3098159436,1571744699,1526414737,1571560485,184214,0,0,0,0,0,0,1526234493,180244,0,0,0,0,0,0
26.602,3120454807,1590395048,1530059759,1590208490,186558,0,0,0,0,0,0,1529878769,180990,0,0,0,0,0,0
26.827,3164677848,1608414330,1556263518,1608225715,188615,0,0,0,0,0,0,1556079558,183960,0,0,0,0,0,0
27.060,3278107003,1667416515,1610690488,1667221173,195342,0,0,0,0,0,0,1610500194,190294,0,0,0,0,0,0
27.268,3326714468,1693519796,1633194672,1693321215,198581,0,0,0,0,0,0,1633001544,193128,0,0,0,0,0,0
27.490,3376378129,1714418996,1661959133,1714218031,200965,0,0,0,0,0,0,1661762744,196389,0,0,0,0,0,0
27.705,3479783689,1761911943,1717871746,1761705476,206467,0,0,0,0,0,0,1717668826,202920,0,0,0,0,0,0
27.915,3533021508,1796645780,1736375728,1796435158,210622,0,0,0,0,0,0,1736170443,205285,0,0,0,0,0,0
28.130,3549777070,1805126010,1744651060,1804914393,211617,0,0,0,0,0,0,1744444824,206236,0,0,0,0,0,0
28.342,3647783363,1846645907,1801137456,1846429469,216438,0,0,0,0,0,0,1800924760,212696,0,0,0,0,0,0
28.551,3737263129,1897819154,1839443975,1897596882,222272,0,0,0,0,0,0,1839226787,217188,0,0,0,0,0,0
28.759,3739288386,1899772388,1839515998,1899549708,222680,0,0,0,0,0,0,1839298548,217450,0,0,0,0,0,0
28.967,3847433106,1948038168,1899394938,1947809923,228245,0,0,0,0,0,0,1899170632,224306,0,0,0,0,0,0
29.177,3943575879,2001326508,1942249371,2001092068,234440,0,0,0,0,0,0,1942019979,229392,0,0,0,0,0,0
29.385,3945554048,2002899265,1942654783,2002664515,234750,0,0,0,0,0,0,1942425147,229636,0,0,0,0,0,0
29.592,4011556159,2038390492,1973165667,2038151701,238791,0,0,0,0,0,0,1972932476,233191,0,0,0,0,0,0
29.810,4103276839,2076951475,2026325364,2076708177,243298,0,0,0,0,0,0,2026086069,239295,0,0,0,0,0,0
30.017,4151828970,2106031278,2045797692,2105784416,246862,0,0,0,0,0,0,2045555847,241845,0,0,0,0,0,0
30.227,4222570595,2132515020,2090055575,2132265102,249918,0,0,0,0,0,0,2089808741,246834,0,0,0,0,0,0
30.438,4324765822,2178954105,2145811717,2178698869,255236,0,0,0,0,0,0,2145558462,253255,0,0,0,0,0,0
30.645,4358077098,2209149400,2148927698,2208890613,258787,0,0,0,0,0,0,2148673773,253925,0,0,0,0,0,0
30.857,4412300995,2233515983,2178785012,2233254403,261580,0,0,0,0,0,0,2178527705,257307,0,0,0,0,0,0
31.075,4520055599,2278154306,2241901293,2277887488,266818,0,0,0,0,0,0,2241636740,264553,0,0,0,0,0,0
31.283,4564332507,2312275122,2252057385,2312004296,270826,0,0,0,0,0,0,2251791366,266019,0,0,0,0,0,0
31.493,4581096333,2320754834,2260341499,2320483029,271805,0,0,0,0,0,0,2260074540,266959,0,0,0,0,0,0
31.712,4676951576,2362278378,2314673198,2362001750,276628,0,0,0,0,0,0,2314399961,273237,0,0,0,0,0,0
31.921,4770537086,2415371376,2355165710,2415088602,282774,0,0,0,0,0,0,2354887596,278114,0,0,0,0,0,0
32.129,4770594835,2415401921,2355192914,2415119090,282831,0,0,0,0,0,0,2354914709,278205,0,0,0,0,0,0
32.339,4850218485,2464516799,2385701686,2464228422,288377,0,0,0,0,0,0,2385419883,281803,0,0,0,0,0,0
32.548,4958632667,2500873640,2457759027,2500580968,292672,0,0,0,0,0,0,2457469006,290021,0,0,0,0,0,0
32.755,4976848862,2518521959,2458326903,2518227118,294841,0,0,0,0,0,0,2458036537,290366,0,0,0,0,0,0
32.963,5051103046,2562274599,2488828447,2561974829,299770,0,0,0,0,0,0,2488534533,293914,0,0,0,0,0,0
33.171,5129011598,2586962832,2542048766,2586660162,302670,0,0,0,0,0,0,2541748812,299954,0,0,0,0,0,0
33.378,5183092718,2621640057,2561452661,2621333292,306765,0,0,0,0,0,0,2561150253,302408,0,0,0,0,0,0
33.595,5238210398,2642790365,2595420033,2642481129,309236,0,0,0,0,0,0,2595113738,306295,0,0,0,0,0,0
33.810,5346204924,2684734101,2661470823,2684419891,314210,0,0,0,0,0,0,2661156964,313859,0,0,0,0,0,0
34.016,5389490153,2724905887,2664584266,2724586962,318925,0,0,0,0,0,0,2664269780,314486,0,0,0,0,0,0
34.233,5430429365,2739394050,2691035315,2739073459,320591,0,0,0,0,0,0,2690717861,317454,0,0,0,0,0,0
34.442,5522759054,2791324663,2731434391,2790998123,326540,0,0,0,0,0,0,2731112216,322175,0,0,0,0,0,0
34.655,5595749925,2828034650,2767715275,2827703645,331005,0,0,0,0,0,0,2767388698,326577,0,0,0,0,0,0
34.869,5612452080,2832279211,2780172869,2831947705,331506,0,0,0,0,0,0,2779844883,327986,0,0,0,0,0,0
35.079,5723707021,2877449330,2846257691,2877112604,336726,0,0,0,0,0,0,2845922162,335529,0,0,0,0,0,0
35.288,5800267194,2929484186,2870783008,2929141540,342646,0,0,0,0,0,0,2870444522,338486,0,0,0,0,0,0
35.496,5802001063,2931159715,2870841348,2930816809,342906,0,0,0,0,0,0,2870502741,338607,0,0,0,0,0,0
35.707,5916029645,2980018697,2936010948,2979670209,348488,0,0,0,0,0,0,2935664866,346082,0,0,0,0,0,0
35.914,6006065401,3032493569,2973571832,3032139080,354489,0,0,0,0,0,0,2973221315,350517,0,0,0,0,0,0
36.120,6008266857,3034283935,2973982922,3033929039,354896,0,0,0,0,0,0,2973632134,350788,0,0,0,0,0,0
36.329,6109512397,3078033214,3031479183,3077673299,359915,0,0,0,0,0,0,3031121796,357387,0,0,0,0,0,0
36.536,6208415702,3134189242,3074226460,3133822930,366312,0,0,0,0,0,0,3073864088,362372,0,0,0,0,0,0
36.743,6214524202,3137405432,3077118770,3137038566,366866,0,0,0,0,0,0,3076755875,362895,0,0,0,0,0,0
36.953,6305697385,3175591118,3130106267,3175219885,371233,0,0,0,0,0,0,3129737366,368901,0,0,0,0,0,0
37.161,6414305732,3237162105,3177143627,3236783803,378302,0,0,0,0,0,0,3176769278,374349,0,0,0,0,0,0
37.368,6420794758,3240537905,3180256853,3240158898,379007,0,0,0,0,0,0,3179881815,375038,0,0,0,0,0,0
37.579,6487623795,3270988613,3216635182,3270606172,382441,0,0,0,0,0,0,3216256036,379146,0,0,0,0,0,0
37.804,6609239213,3330361685,3278877528,3329972391,389294,0,0,0,0,0,0,3278491246,386282,0,0,0,0,0,0
38.010,6627049913,3343663563,3283386350,3343272548,391015,0,0,0,0,0,0,3282999224,387126,0,0,0,0,0,0
38.240,6685945729,3376290657,3309655072,3375895949,394708,0,0,0,0,0,0,3309264937,390135,0,0,0,0,0,0
38.450,6789332144,3414436122,3374896022,3414036883,399239,0,0,0,0,0,0,3374498350,397672,0,0,0,0,0,0
38.658,6833313296,3446795376,3386517920,3446392253,403123,0,0,0,0,0,0,3386118666,399254,0,0,0,0,0,0
38.868,6841791854,3455272603,3386519251,3454868530,404073,0,0,0,0,0,0,3386119979,399272,0,0,0,0,0,0
39.076,6918744650,3496175671,3422568979,3495766934,408737,0,0,0,0,0,0,3422165539,403440,0,0,0,0,0,0
39.293,7034010748,3544477767,3489532981,3544063384,414383,0,0,0,0,0,0,3489121806,411175,0,0,0,0,0,0
39.500,7039572640,3549924692,3489647948,3549509500,415192,0,0,0,0,0,0,3489236591,411357,0,0,0,0,0,0
39.710,7147770801,3598189685,3549581116,3597768907,420778,0,0,0,0,0,0,3549162922,418194,0,0,0,0,0,0
39.917,7240784914,3650171436,3590613478,3649744720,426716,0,0,0,0,0,0,3590190545,422933,0,0,0,0,0,0
40.124,7245881644,3653046276,3592835368,3652619102,427174,0,0,0,0,0,0,3592412007,423361,0,0,0,0,0,0
40.334,7342886180,3694683201,3648202979,3694251250,431951,0,0,0,0,0,0,3647773300,429679,0,0,0,0,0,0
40.544,7446823202,3753219552,3693603650,3752780922,438630,0,0,0,0,0,0,3693168735,434915,0,0,0,0,0,0
40.751,7452131938,3756168694,3695963244,3755729531,439163,0,0,0,0,0,0,3695527818,435426,0,0,0,0,0,0
40.964,7529144798,3785040331,3744104467,3784597825,442506,0,0,0,0,0,0,3743663531,440936,0,0,0,0,0,0
41.176,7623588797,3827008712,3796580085,3826561353,447359,0,0,0,0,0,0,3796133100,446985,0,0,0,0,0,0
41.383,7658390232,3859297427,3799092805,3858846204,451223,0,0,0,0,0,0,3798645282,447523,0,0,0,0,0,0
41.596,7709058111,3879465125,3829592986,3879011563,453562,0,0,0,0,0,0,3829142015,450971,0,0,0,0,0,0
41.817,7812974347,3923142437,3889831910,3922683767,458670,0,0,0,0,0,0,3889373951,457959,0,0,0,0,0,0
42.025,7864673023,3962430952,3902242071,3961967626,463326,0,0,0,0,0,0,3901782306,459765,0,0,0,0,0,0
42.238,7895096306,3975774672,3919321634,3975309803,464869,0,0,0,0,0,0,3918859925,461709,0,0,0,0,0,0
42.451,7986855921,4008224547,3978631374,4007755864,468683,0,0,0,0,0,0,3978162781,468593,0,0,0,0,0,0
42.664,8070845619,4065510484,4005335135,4065035231,475253,0,0,0,0,0,0,4004863317,471818,0,0,0,0,0,0
42.871,8070938375,4065561975,4005376400,4065086557,475418,0,0,0,0,0,0,4004904479,471921,0,0,0,0,0,0
43.082,8172480363,4106165937,4066314426,4105685744,480193,0,0,0,0,0,0,4065835556,478870,0,0,0,0,0,0
43.292,8274964703,4168411291,4106553412,4167923999,487292,0,0,0,0,0,0,4106069858,483554,0,0,0,0,0,0
43.501,8277201977,4168693130,4108508847,4168205606,487524,0,0,0,0,0,0,4108024820,484027,0,0,0,0,0,0
43.710,8379532363,4213533610,4165998753,4213040951,492659,0,0,0,0,0,0,4165508137,490616,0,0,0,0,0,0
43.917,8476665999,4268667247,4207998752,4268168302,498945,0,0,0,0,0,0,4207503259,495493,0,0,0,0,0,0
44.124,8483450114,4271814002,4211636112,4271314508,499494,0,0,0,0,0,0,4211140029,496083,0,0,0,0,0,0
44.337,8569528567,4301739012,4267789555,4301236054,502958,0,0,0,0,0,0,4267287067,502488,0,0,0,0,0,0
44.549,8673534244,4361872288,4311661956,4361362428,509860,0,0,0,0,0,0,4311154333,507623,0,0,0,0,0,0
44.756,8689711854,4374942509,4314769345,4374430936,511573,0,0,0,0,0,0,4314261115,508230,0,0,0,0,0,0
44.973,8756310372,4406480901,4349829471,4405965750,515151,0,0,0,0,0,0,4349317245,512226,0,0,0,0,0,0
45.215,8889392487,4474001375,4415391112,4473478485,522890,0,0,0,0,0,0,4414871294,519818,0,0,0,0,0,0
45.422,8895961318,4478062175,4417899143,4477538641,523534,0,0,0,0,0,0,4417378801,520342,0,0,0,0,0,0
45.636,8963982418,4508414004,4455568414,4507887043,526961,0,0,0,0,0,0,4455043820,524594,0,0,0,0,0,0
45.856,9074292914,4556973806,4517319108,4556441238,532568,0,0,0,0,0,0,4516787425,531683,0,0,0,0,0,0
46.062,9102217616,4581188274,4521029342,4580652697,535577,0,0,0,0,0,0,4520496890,532452,0,0,0,0,0,0
46.273,9150533284,4603544236,4546989048,4603006115,538121,0,0,0,0,0,0,4546453672,535376,0,0,0,0,0,0
46.511,9286167613,4666251663,4619915950,4665706349,545314,0,0,0,0,0,0,4619372193,543757,0,0,0,0,0,0
46.719,9308745079,4684579592,4624165487,4684031887,547705,0,0,0,0,0,0,4623620862,544625,0,0,0,0,0,0
46.938,9353032157,4702600468,4650431689,4702050676,549792,0,0,0,0,0,0,4649884081,547608,0,0,0,0,0,0
47.168,9465871305,4761704560,4704166745,4761148078,556482,0,0,0,0,0,0,4703613012,553733,0,0,0,0,0,0
47.377,9514987431,4787698377,4727289054,4787138736,559641,0,0,0,0,0,0,4726732428,556626,0,0,0,0,0,0
47.587,9523974210,4791941463,4732032747,4791381346,560117,0,0,0,0,0,0,4731475577,557170,0,0,0,0,0,0
47.794,9602208369,4837085994,4765122375,4836520775,565219,0,0,0,0,0,0,4764561431,560944,0,0,0,0,0,0
48.002,9686779895,4856504438,4830275457,4855936830,567608,0,0,0,0,0,0,4829707090,568367,0,0,0,0,0,0
48.210,9721225336,4890818443,4830406893,4890246847,571596,0,0,0,0,0,0,4829838346,568547,0,0,0,0,0,0
48.418,9777675018,4925239933,4852435085,4924664450,575483,0,0,0,0,0,0,4851863953,571132,0,0,0,0,0,0
48.627,9879937472,4980882773,4899054699,4980300929,581844,0,0,0,0,0,0,4898478214,576485,0,0,0,0,0,0
48.834,9927475040,4993938948,4933536092,4993355383,583565,0,0,0,0,0,0,4932955465,580627,0,0,0,0,0,0
49.060,10003810901,5020418726,4983392175,5019832133,586593,0,0,0,0,0,0,4982805956,586219,0,0,0,0,0,0
49.270,10104015228,5071057115,5032958113,5070464685,592430,0,0,0,0,0,0,5032366103,592010,0,0,0,0,0,0
49.477,10133717450,5097056394,5036661056,5096460903,595491,0,0,0,0,0,0,5036068422,592634,0,0,0,0,0,0
49.710,10190470551,5123316516,5067154035,5122718049,598467,0,0,0,0,0,0,5066557945,596090,0,0,0,0,0,0
49.958,10324945382,5187668561,5137276821,5187062668,605893,0,0,0,0,0,0,5136672644,604177,0,0,0,0,0,0
50.165,10340171748,5200376731,5139795017,5199769124,607607,0,0,0,0,0,0,5139190230,604787,0,0,0,0,0,0
50.388,10401230945,5232329234,5168901711,5231717988,611246,0,0,0,0,0,0,5168293594,608117,0,0,0,0,0,0
50.602,10505937445,5267218137,5238719308,5266602718,615419,0,0,0,0,0,0,5238103173,616135,0,0,0,0,0,0
50.809,10546471192,5303507313,5242963879,5302887599,619714,0,0,0,0,0,0,5242346943,616936,0,0,0,0,0,0
51.039,10593489500,5324260210,5269229290,5323638118,622092,0,0,0,0,0,0,5268609367,619923,0,0,0,0,0,0
51.256,10705678672,5363772498,5341906174,5363145707,626791,0,0,0,0,0,0,5341277952,628222,0,0,0,0,0,0
51.463,10753058879,5406640774,5346418105,5406008928,631846,0,0,0,0,0,0,5345788974,629131,0,0,0,0,0,0
51.676,10769938753,5415248152,5354690601,5414615319,632833,0,0,0,0,0,0,5354060519,630082,0,0,0,0,0,0
51.884,10865056138,5456631075,5408425063,5455993441,637634,0,0,0,0,0,0,5407788778,636285,0,0,0,0,0,0
52.091,10959158242,5509710743,5449447499,5509067015,643728,0,0,0,0,0,0,5448806403,641096,0,0,0,0,0,0
52.298,10959324391,5509766442,5449557949,5509122556,643886,0,0,0,0,0,0,5448916739,641210,0,0,0,0,0,0
52.506,11063425682,5549760255,5513665427,5549111698,648557,0,0,0,0,0,0,5513016915,648512,0,0,0,0,0,0
52.714,11162147034,5610019136,5552127898,5609363724,655412,0,0,0,0,0,0,5551474875,653023,0,0,0,0,0,0
52.921,11165573482,5612887953,5552685529,5612232103,655850,0,0,0,0,0,0,5552032251,653278,0,0,0,0,0,0
53.129,11246364792,5637258324,5609106468,5636599632,658692,0,0,0,0,0,0,5608446853,659615,0,0,0,0,0,0
53.337,11336746718,5699528140,5637218578,5698862408,665732,0,0,0,0,0,0,5636555546,663032,0,0,0,0,0,0
53.544,11371812960,5716007270,5655805690,5715339495,667775,0,0,0,0,0,0,5655140441,665249,0,0,0,0,0,0
53.764,11450999921,5744334126,5706665795,5743663017,671109,0,0,0,0,0,0,5705994802,670993,0,0,0,0,0,0
53.979,11550159037,5796715409,5753443628,5796038271,677138,0,0,0,0,0,0,5752767191,676437,0,0,0,0,0,0
54.186,11578088050,5819143482,5758944568,5818463542,679940,0,0,0,0,0,0,5758267147,677421,0,0,0,0,0,0
54.402,11623102981,5841382189,5781720792,5840699721,682468,0,0,0,0,0,0,5781040809,679983,0,0,0,0,0,0
54.612,11726773658,5869212325,5857561333,5868526549,685776,0,0,0,0,0,0,5856872718,688615,0,0,0,0,0,0
54.821,11784335740,5922264220,5862071520,5921572304,691916,0,0,0,0,0,0,5861382088,689432,0,0,0,0,0,0
55.029,11796234656,5930733919,5865500737,5930041042,692877,0,0,0,0,0,0,5864810880,689857,0,0,0,0,0,0
55.241,11862729300,5964578666,5898150634,5963881949,696717,0,0,0,0,0,0,5897456972,693662,0,0,0,0,0,0
55.448,11983187018,6018084505,5965102513,6017381525,702980,0,0,0,0,0,0,5964401136,701377,0,0,0,0,0,0
55.656,11990600609,6025386590,5965214019,6024682691,703899,0,0,0,0,0,0,5964512432,701587,0,0,0,0,0,0
55.868,12090468214,6065384147,6025084067,6064675637,708510,0,0,0,0,0,0,6024375702,708365,0,0,0,0,0,0
56.076,12191755430,6125379380,6066376050,6124664042,715338,0,0,0,0,0,0,6065662928,713122,0,0,0,0,0,0
56.282,12196853213,6128514291,6068338922,6127798326,715965,0,0,0,0,0,0,6067625327,713595,0,0,0,0,0,0
56.490,12283217358,6159512399,6123704959,6158792853,719546,0,0,0,0,0,0,6122985050,719909,0,0,0,0,0,0
56.699,12396784743,6228420006,6168364737,6227692637,727369,0,0,0,0,0,0,6167639569,725168,0,0,0,0,0,0
56.906,12403106650,6231635499,6171471151,6230907548,727951,0,0,0,0,0,0,6170745425,725726,0,0,0,0,0,0
57.114,12464115002,6266381662,6197733340,6265649793,731869,0,0,0,0,0,0,6197004548,728792,0,0,0,0,0,0
57.333,12558989674,6310640822,6248348852,6309903925,736897,0,0,0,0,0,0,6247614281,734571,0,0,0,0,0,0
57.540,12609358148,6334756849,6274601299,6334016934,739915,0,0,0,0,0,0,6273863475,737824,0,0,0,0,0,0
57.750,12619208733,6338998689,6280210044,6338258281,740408,0,0,0,0,0,0,6279471587,738457,0,0,0,0,0,0
57.961,12708214278,6371595419,6336618859,6370851221,744198,0,0,0,0,0,0,6335874016,744843,0,0,0,0,0,0
58.171,12807729087,6433805359,6373923728,6433054048,751311,0,0,0,0,0,0,6373174438,749290,0,0,0,0,0,0
58.378,12815604585,6437878082,6377726503,6437126205,751877,0,0,0,0,0,0,6376976663,749840,0,0,0,0,0,0
58.588,12915478104,6477879780,6437598324,6477123228,756552,0,0,0,0,0,0,6436841651,756673,0,0,0,0,0,0
58.795,13016554365,6537591995,6478962370,6536828668,763327,0,0,0,0,0,0,6478200905,761465,0,0,0,0,0,0
59.002,13021854549,6541001728,6480852821,6540237854,763874,0,0,0,0,0,0,6480090954,761867,0,0,0,0,0,0
59.209,13081494373,6574370361,6507124012,6573602704,767657,0,0,0,0,0,0,6506359092,764920,0,0,0,0,0,0
59.416,13165374158,6606505387,6558868771,6605733959,771428,0,0,0,0,0,0,6558097948,770823,0,0,0,0,0,0
59.623,13228106308,6644126543,6583979765,6643350629,775914,0,0,0,0,0,0,6583205844,773921,0,0,0,0,0,0
59.835,13276354507,6662269141,6614085366,6661491121,778020,0,0,0,0,0,0,6613308019,777347,0,0,0,0,0,0
60.070,13404250459,6720797942,6683452517,6720013196,784746,0,0,0,0,0,0,6682667129,785388,0,0,0,0,0,0
60.276,13434470668,6747313784,6687156884,6746525866,787918,0,0,0,0,0,0,6686370837,786047,0,0,0,0,0,0
60.496,13469097338,6765321944,6703775394,6764532005,789939,0,0,0,0,0,0,6702987456,787938,0,0,0,0,0,0
60.713,13595135788,6808765239,6786370549,6807970212,795027,0,0,0,0,0,0,6785573172,797377,0,0,0,0,0,0
60.922,13640718540,6850439730,6790278810,6849639768,799962,0,0,0,0,0,0,6789480611,798199,0,0,0,0,0,0
61.132,13655545853,6857074058,6798471795,6856273321,800737,0,0,0,0,0,0,6797672634,799161,0,0,0,0,0,0
61.339,13756376315,6899839855,6856536460,6899034156,805699,0,0,0,0,0,0,6855730607,805853,0,0,0,0,0,0
61.547,13844071200,6950751255,6893319945,6949939729,811526,0,0,0,0,0,0,6892509797,810148,0,0,0,0,0,0
61.759,13846991175,6953568170,6893423005,6952756154,812016,0,0,0,0,0,0,6892612681,810324,0,0,0,0,0,0
61.968,13946869017,6993571375,6953297642,6992754729,816646,0,0,0,0,0,0,6952480477,817165,0,0,0,0,0,0
62.175,14047455450,7053863549,6993591901,7053040066,823483,0,0,0,0,0,0,6992770081,821820,0,0,0,0,0,0
62.381,14053245105,7056690258,6996554847,7055866260,823998,0,0,0,0,0,0,6995732420,822427,0,0,0,0,0,0
62.591,14152385585,7099390963,7052994622,7098562083,828880,0,0,0,0,0,0,7052165779,828843,0,0,0,0,0,0
62.798,14253897883,7156577697,7097320186,7155742266,835431,0,0,0,0,0,0,7096486212,833974,0,0,0,0,0,0
63.005,14259503055,7159818629,7099684426,7158982562,836067,0,0,0,0,0,0,7098849921,834505,0,0,0,0,0,0
63.215,14349617198,7198011032,7151606166,7197170601,840431,0,0,0,0,0,0,7150765773,840393,0,0,0,0,0,0
63.439,14442207290,7260300593,7181906697,7259453046,847547,0,0,0,0,0,0,7181062653,844044,0,0,0,0,0,0
63.645,14465763526,7262943963,7202819563,7262095856,848107,0,0,0,0,0,0,7201972905,846658,0,0,0,0,0,0
63.868,14551360439,7300062695,7251297744,7299210387,852308,0,0,0,0,0,0,7250445638,852106,0,0,0,0,0,0
64.081,14643015700,7340781041,7302234659,7339924020,857021,0,0,0,0,0,0,7301376696,857963,0,0,0,0,0,0
64.288,14672005760,7366066497,7305939263,7365206410,860087,0,0,0,0,0,0,7305080652,858611,0,0,0,0,0,0
64.498,14709284088,7372851937,7336432151,7371991001,860936,0,0,0,0,0,0,7335570111,862040,0,0,0,0,0,0
64.724,14840567048,7435143848,7405423200,7434275737,868111,0,0,0,0,0,0,7404553214,869986,0,0,0,0,0,0
64.931,14878254891,7469193290,7409061601,7468321161,872129,0,0,0,0,0,0,7408191000,870601,0,0,0,0,0,0
65.144,14905058262,7477683950,7427374312,7476810841,873109,0,0,0,0,0,0,7426501653,872659,0,0,0,0,0,0
65.404,15063088791,7555138398,7507950393,7554256413,881985,0,0,0,0,0,0,7507068438,881955,0,0,0,0,0,0
65.611,15084519299,7572321623,7512197676,7571437421,884202,0,0,0,0,0,0,7511314920,882756,0,0,0,0,0,0
65.828,15116875951,7580994920,7535881031,7580109696,885224,0,0,0,0,0,0,7534995621,885410,0,0,0,0,0,0
66.036,15221125071,7618269264,7602855807,7617379687,889577,0,0,0,0,0,0,7601962675,893132,0,0,0,0,0,0
66.242,15290635651,7675392044,7615243607,7674495963,896081,0,0,0,0,0,0,7614348769,894838,0,0,0,0,0,0
66.449,15290783766,7675443834,7615339932,7674547650,896184,0,0,0,0,0,0,7614444909,895023,0,0,0,0,0,0
66.657,15398920529,7723705471,7675215058,7722803757,901714,0,0,0,0,0,0,7674313186,901872,0,0,0,0,0,0
66.865,15493301818,7777650006,7715651812,7776742082,907924,0,0,0,0,0,0,7714745193,906619,0,0,0,0,0,0
67.071,15497562193,7779088969,7718473224,7778180630,908339,0,0,0,0,0,0,7717566057,907167,0,0,0,0,0,0
67.278,15566531011,7821784104,7744746907,7820870950,913154,0,0,0,0,0,0,7743836658,910249,0,0,0,0,0,0
67.486,15640154737,7843517665,7796637072,7842601917,915748,0,0,0,0,0,0,7795720918,916154,0,0,0,0,0,0
67.693,15703813998,7882210004,7821603994,7881289706,920298,0,0,0,0,0,0,7820684718,919276,0,0,0,0,0,0
67.903,15773532668,7908699317,7864833351,7907775917,923400,0,0,0,0,0,0,7863909213,924138,0,0,0,0,0,0
68.123,15894349892,7972292454,7922057438,7971361796,930658,0,0,0,0,0,0,7921126698,930740,0,0,0,0,0,0
68.330,15910583416,7985408220,7925175196,7984475765,932455,0,0,0,0,0,0,7924243777,931419,0,0,0,0,0,0
68.539,15954856237,8003418621,7951437616,8002484119,934502,0,0,0,0,0,0,7950503239,934377,0,0,0,0,0,0
68.762,16035807145,8046813892,7988993253,8045874469,939423,0,0,0,0,0,0,7988054556,938697,0,0,0,0,0,0
68.975,16116843665,8088532797,8028310868,8087588327,944470,0,0,0,0,0,0,8027367281,943587,0,0,0,0,0,0
69.191,16139806151,8097014005,8042792146,8096068543,945462,0,0,0,0,0,0,8041846917,945229,0,0,0,0,0,0
69.402,16251262550,8141919954,8109342596,8140969216,950738,0,0,0,0,0,0,8108389751,952845,0,0,0,0,0,0
69.610,16321387523,8190001892,8131385631,8189045591,956301,0,0,0,0,0,0,8130430096,955535,0,0,0,0,0,0
69.817,16323117088,8191668505,8131448583,8190711855,956650,0,0,0,0,0,0,8130492820,955763,0,0,0,0,0,0
70.025,16423585967,8232256738,8191329229,8231295397,961341,0,0,0,0,0,0,8190366650,962579,0,0,0,0,0,0
70.232,16525553243,8291387602,8234165641,8290419523,968079,0,0,0,0,0,0,8233198061,967580,0,0,0,0,0,0
70.440,16529367196,8294788878,8234578318,8293820259,968619,0,0,0,0,0,0,8233610472,967846,0,0,0,0,0,0
70.647,16593245278,8328162437,8265082841,8327189991,972446,0,0,0,0,0,0,8264111517,971324,0,0,0,0,0,0
70.855,16670284208,8367186306,8303097902,8366209370,976936,0,0,0,0,0,0,8302122143,975759,0,0,0,0,0,0
71.061,16735620879,8397914036,8337706843,8396933396,980640,0,0,0,0,0,0,8336726921,979922,0,0,0,0,0,0
71.276,16800060769,8422268518,8377792251,8421285118,983400,0,0,0,0,0,0,8376807778,984473,0,0,0,0,0,0
71.497,16924997068,8488396127,8436600941,8487405170,990957,0,0,0,0,0,0,8435609577,991364,0,0,0,0,0,0
71.703,16941878446,8501035315,8440843131,8500042711,992604,0,0,0,0,0,0,8439851010,992121,0,0,0,0,0,0
71.918,16985522302,8519036994,8466485308,8518042340,994654,0,0,0,0,0,0,8465490293,995015,0,0,0,0,0,0
72.130,17091812570,8557934726,8533877844,8556935474,999252,0,0,0,0,0,0,8532875078,1002766,0,0,0,0,0,0
72.339,17148143229,8604166610,8543976619,8603161894,1004716,0,0,0,0,0,0,8542972345,1004274,0,0,0,0,0,0
72.552,17154342779,8608408366,8545934413,8607403159,1005207,0,0,0,0,0,0,8544929905,1004508,0,0,0,0,0,0
72.760,17259339747,8645043593,8614296154,8644034088,1009505,0,0,0,0,0,0,8613283864,1012290,0,0,0,0,0,0
72.968,17351506647,8704477774,8647028873,8703461490,1016284,0,0,0,0,0,0,8646012704,1016169,0,0,0,0,0,0
73.174,17354444290,8707293732,8647150558,8706276976,1016756,0,0,0,0,0,0,8646134188,1016370,0,0,0,0,0,0
73.383,17449814070,8742781241,8707032829,8741760391,1020850,0,0,0,0,0,0,8706009567,1023262,0,0,0,0,0,0
73.590,17554390518,8806999877,8747390641,8805971730,1028147,0,0,0,0,0,0,8746362682,1027959,0,0,0,0,0,0
73.797,17560690001,8810414440,8750275561,8809385732,1028708,0,0,0,0,0,0,8749247146,1028415,0,0,0,0,0,0
74.008,17653714553,8840342490,8813372063,8839310299,1032191,0,0,0,0,0,0,8812336570,1035493,0,0,0,0,0,0
74.217,17761324007,8910169622,8851154385,8909129478,1040144,0,0,0,0,0,0,8850114451,1039934,0,0,0,0,0,0
74.424,17766946032,8913544235,8853401797,8912503449,1040786,0,0,0,0,0,0,8852361339,1040458,0,0,0,0,0,0
74.640,17850897857,8942412948,8908484909,8941368841,1044107,0,0,0,0,0,0,8907438271,1046638,0,0,0,0,0,0
74.851,17957914338,9004496732,8953417606,9003445504,1051228,0,0,0,0,0,0,8952365715,1051891,0,0,0,0,0,0
75.057,17973201583,9016670394,8956531189,9015617559,1052835,0,0,0,0,0,0,8955478643,1052546,0,0,0,0,0,0
75.287,18029123699,9042097224,8987026475,9041041453,1055771,0,0,0,0,0,0,8985970464,1056011,0,0,0,0,0,0
75.517,18152048920,9097155887,9054893033,9096093754,1062133,0,0,0,0,0,0,9053829130,1063903,0,0,0,0,0,0
75.724,18179464684,9119800820,9059663864,9118735881,1064939,0,0,0,0,0,0,9058599167,1064697,0,0,0,0,0,0
75.933,18217435782,9132653010,9084782772,9131586586,1066424,0,0,0,0,0,0,9083715207,1067565,0,0,0,0,0,0
76.156,18306614847,9183801523,9122813324,9182729316,1072207,0,0,0,0,0,0,9121741318,1072006,0,0,0,0,0,0
76.373,18385943870,9222883167,9163060703,9221806333,1076834,0,0,0,0,0,0,9161983808,1076895,0,0,0,0,0,0
76.580,18385994208,9222929098,9163065110,9221852131,1076967,0,0,0,0,0,0,9161988153,1076957,0,0,0,0,0,0
76.788,18501089536,9272052897,9229036639,9270970205,1082692,0,0,0,0,0,0,9227952058,1084581,0,0,0,0,0,0
76.996,18588995182,9322915426,9266079756,9321826914,1088512,0,0,0,0,0,0,9264990792,1088964,0,0,0,0,0,0
77.203,18592257208,9326052942,9266204266,9324963915,1089027,0,0,0,0,0,0,9265115076,1089190,0,0,0,0,0,0
77.409,18666508170,9369805658,9296702512,9368711669,1093989,0,0,0,0,0,0,9295609818,1092694,0,0,0,0,0,0
77.616,18746247725,9401879973,9344367752,9400782289,1097684,0,0,0,0,0,0,9343269626,1098126,0,0,0,0,0,0
77.823,18798504791,9429173732,9369331059,9428072760,1100972,0,0,0,0,0,0,9368229819,1101240,0,0,0,0,0,0
78.031,18880452310,9459107019,9421345291,9458002583,1104436,0,0,0,0,0,0,9420238145,1107146,0,0,0,0,0,0
78.239,18981582286,9528546561,9453035725,9527434257,1112304,0,0,0,0,0,0,9451924757,1110968,0,0,0,0,0,0
78.446,19004887966,9532329415,9472558551,9531216374,1113041,0,0,0,0,0,0,9471445093,1113458,0,0,0,0,0,0
78.659,19042226171,9547148194,9495077977,9546033427,1114767,0,0,0,0,0,0,9493961977,1116000,0,0,0,0,0,0
78.878,19157510417,9586320670,9571189747,9585201204,1119466,0,0,0,0,0,0,9570064998,1124749,0,0,0,0,0,0
79.086,19211152443,9635460013,9575692430,9634334868,1125145,0,0,0,0,0,0,9574566881,1125549,0,0,0,0,0,0
79.294,19215402006,9639701520,9575700486,9638575888,1125632,0,0,0,0,0,0,9574574904,1125582,0,0,0,0,0,0
79.502,19322303993,9684862044,9637441949,9683731084,1130960,0,0,0,0,0,0,9636309252,1132697,0,0,0,0,0,0
79.714,19415778657,9737063861,9678714796,9735926866,1136995,0,0,0,0,0,0,9677577300,1137496,0,0,0,0,0,0
79.921,19417420463,9738589874,9678830589,9737452619,1137255,0,0,0,0,0,0,9677692908,1137681,0,0,0,0,0,0
80.134,19525545838,9786844599,9738701239,9785701757,1142842,0,0,0,0,0,0,9737556739,1144500,0,0,0,0,0,0
80.345,19619906572,9838576582,9781329990,9837427801,1148781,0,0,0,0,0,0,9780180557,1149433,0,0,0,0,0,0
80.552,19623674728,9841719084,9781955644,9840569752,1149332,0,0,0,0,0,0,9780805931,1149713,0,0,0,0,0,0
80.758,19700042701,9883355396,9816687305,9882201330,1154066,0,0,0,0,0,0,9815533588,1153717,0,0,0,0,0,0
80.970,19785262409,9923154022,9862108387,9921995340,1158682,0,0,0,0,0,0,9860949464,1158923,0,0,0,0,0,0
81.177,19829944026,9944850557,9885093469,9943689114,1161443,0,0,0,0,0,0,9883931612,1161857,0,0,0,0,0,0
81.400,19917483086,9981982312,9935500774,9980816641,1165671,0,0,0,0,0,0,9934333187,1167587,0,0,0,0,0,0
81.622,20029718002,10044602797,9985115205,10043429981,1172816,0,0,0,0,0,0,9983941805,1173400,0,0,0,0,0,0
81.829,20036201513,10047975790,9988225723,10046802344,1173446,0,0,0,0,0,0,9987051726,1173997,0,0,0,0,0,0
82.075,20122488907,10094799244,10027689663,10093620474,1178770,0,0,0,0,0,0,10026511189,1178474,0,0,0,0,0,0
82.299,20235647661,10148000371,10087647290,10146815442,1184929,0,0,0,0,0,0,10086461924,1185366,0,0,0,0,0,0
82.507,20242455709,10151103857,10091351852,10149918333,1185524,0,0,0,0,0,0,10090165806,1186046,0,0,0,0,0,0
82.722,20293430833,10173351307,10120079526,10172163253,1188054,0,0,0,0,0,0,10118890255,1189271,0,0,0,0,0,0
82.949,20419870508,10229041521,10190828987,10227846984,1194537,0,0,0,0,0,0,10189631640,1197347,0,0,0,0,0,0
83.157,20448713611,10254231375,10194482236,10253033770,1197605,0,0,0,0,0,0,10193284098,1198138,0,0,0,0,0,0
83.368,20472712217,10262702775,10210009442,10261504192,1198583,0,0,0,0,0,0,10208809544,1199898,0,0,0,0,0,0
83.580,20581652965,10306272412,10275380553,10305068665,1203747,0,0,0,0,0,0,10274173119,1207434,0,0,0,0,0,0
83.790,20654602154,10357025860,10297576294,10355816283,1209577,0,0,0,0,0,0,10296366180,1210114,0,0,0,0,0,0
83.998,20655001945,10357367797,10297634148,10356157993,1209804,0,0,0,0,0,0,10296423874,1210274,0,0,0,0,0,0
84.208,20768234434,10406226563,10362007871,10405011148,1215415,0,0,0,0,0,0,10360790196,1217675,0,0,0,0,0,0
84.417,20857762687,10457671833,10400090854,10456450495,1221338,0,0,0,0,0,0,10398868690,1222164,0,0,0,0,0,0
84.623,20861265893,10460494363,10400771530,10459272514,1221849,0,0,0,0,0,0,10399549050,1222480,0,0,0,0,0,0
84.829,20905523596,10478490084,10427033512,10477266160,1223924,0,0,0,0,0,0,10425808048,1225464,0,0,0,0,0,0
85.038,21011169937,10541667473,10469502464,10540436358,1231115,0,0,0,0,0,0,10468272064,1230400,0,0,0,0,0,0
85.245,21067523141,10563621214,10503901927,10562387322,1233892,0,0,0,0,0,0,10502667345,1234582,0,0,0,0,0,0
85.456,21137969430,10592478389,10545491041,10591241232,1237157,0,0,0,0,0,0,10544251785,1239256,0,0,0,0,0,0
85.677,21266429520,10662511706,10603917814,10661266522,1245184,0,0,0,0,0,0,10602671751,1246063,0,0,0,0,0,0
85.884,21273790517,10666752957,10607037560,10665506940,1246017,0,0,0,0,0,0,10605790809,1246751,0,0,0,0,0,0
86.095,21321246294,10687943332,10633302962,10686694905,1248427,0,0,0,0,0,0,10632053242,1249720,0,0,0,0,0,0
86.317,21399758473,10733281437,10666477036,10732027853,1253584,0,0,0,0,0,0,10665223510,1253526,0,0,0,0,0,0
86.526,21480043791,10769877967,10710165824,10768619925,1258042,0,0,0,0,0,0,10708906996,1258828,0,0,0,0,0,0
86.735,21485890814,10774119606,10711771208,10772861074,1258532,0,0,0,0,0,0,10710512194,1259014,0,0,0,0,0,0
86.945,21599161385,10819285823,10779875562,10818022052,1263771,0,0,0,0,0,0,10778608782,1266780,0,0,0,0,0,0
87.152,21683372901,10870188189,10813184712,10868918620,1269569,0,0,0,0,0,0,10811914084,1270628,0,0,0,0,0,0
87.360,21686292628,10873002404,10813290224,10871732359,1270045,0,0,0,0,0,0,10812019380,1270844,0,0,0,0,0,0
87.569,21794425147,10921255321,10873169826,10919979720,1275601,0,0,0,0,0,0,10871892065,1277761,0,0,0,0,0,0
87.777,21890256610,10975653769,10914602841,10974371944,1281825,0,0,0,0,0,0,10913320255,1282586,0,0,0,0,0,0
87.983,21892561367,10976132813,10916428554,10974850665,1282148,0,0,0,0,0,0,10915145507,1283047,0,0,0,0,0,0
88.191,21974415149,11006063938,10968351211,11004778369,1285569,0,0,0,0,0,0,10967062259,1288952,0,0,0,0,0,0
88.404,22089223037,11075091255,11014131782,11073797791,1293464,0,0,0,0,0,0,11012837473,1294309,0,0,0,0,0,0
88.611,22098878633,11079256024,11019622609,11077961888,1294136,0,0,0,0,0,0,11018327461,1295148,0,0,0,0,0,0
88.832,22162790203,11101495376,11061294827,11100198690,1296686,0,0,0,0,0,0,11059994986,1299841,0,0,0,0,0,0
89.063,22268971961,11155972824,11112999137,11154669904,1302920,0,0,0,0,0,0,11111693366,1305771,0,0,0,0,0,0
89.271,22305129939,11182382317,11122747622,11181076154,1306163,0,0,0,0,0,0,11121440451,1307171,0,0,0,0,0,0
89.483,22322426823,11191367636,11131059187,11190060459,1307177,0,0,0,0,0,0,11129751075,1308112,0,0,0,0,0,0
89.692,22432570281,11231797087,11200773194,11230485174,1311913,0,0,0,0,0,0,11199457092,1316102,0,0,0,0,0,0
89.900,22509386355,11283606934,11225779421,11282289072,1317862,0,0,0,0,0,0,11224460334,1319087,0,0,0,0,0,0
90.107,22511390184,11285510452,11225879732,11284192319,1318133,0,0,0,0,0,0,11224560455,1319277,0,0,0,0,0,0
90.314,22608199967,11318147835,11290052132,11316825882,1321953,0,0,0,0,0,0,11288725647,1326485,0,0,0,0,0,0
90.522,22705179927,11376740951,11328438976,11375412299,1328652,0,0,0,0,0,0,11327108002,1330974,0,0,0,0,0,0
90.728,22717714133,11388638644,11329075489,11387308463,1330181,0,0,0,0,0,0,11327744188,1331301,0,0,0,0,0,0
90.937,22804860931,11418566208,11386294723,11417232537,1333671,0,0,0,0,0,0,11384956933,1337790,0,0,0,0,0,0
91.147,22914305963,11484341911,11429964052,11483000736,1341175,0,0,0,0,0,0,11428621119,1342933,0,0,0,0,0,0
91.353,22923976403,11491766992,11432209411,11490424735,1342257,0,0,0,0,0,0,11430865951,1343460,0,0,0,0,0,0
91.581,22991328237,11518242148,11473086089,11516896875,1345273,0,0,0,0,0,0,11471738024,1348065,0,0,0,0,0,0
91.797,23097630515,11565407524,11532222991,11564056765,1350759,0,0,0,0,0,0,11530868124,1354867,0,0,0,0,0,0
92.004,23130238518,11594895866,11535342652,11593541527,1354339,0,0,0,0,0,0,11533987062,1355590,0,0,0,0,0,0
92.217,23164048098,11609899577,11554148521,11608543497,1356080,0,0,0,0,0,0,11552790806,1357715,0,0,0,0,0,0
92.439,23260089153,11649024085,11611065068,11647663379,1360706,0,0,0,0,0,0,11609700791,1364277,0,0,0,0,0,0
92.648,23336500663,11698025531,11638475132,11696659088,1366443,0,0,0,0,0,0,11637107427,1367705,0,0,0,0,0,0
92.863,23347751254,11704820874,11642930380,11703453657,1367217,0,0,0,0,0,0,11641562162,1368218,0,0,0,0,0,0
93.075,23453897548,11747423454,11706474094,11746051311,1372143,0,0,0,0,0,0,11705098632,1375462,0,0,0,0,0,0
93.282,23542585549,11801092985,11741492564,11799714699,1378286,0,0,0,0,0,0,11740112950,1379614,0,0,0,0,0,0
93.489,23542757042,11801150027,11741607015,11799771572,1378455,0,0,0,0,0,0,11740227179,1379836,0,0,0,0,0,0
93.697,23650896544,11849411841,11801484703,11848027822,1384019,0,0,0,0,0,0,11800097979,1386724,0,0,0,0,0,0
93.904,23745659784,11901331067,11844328717,11899941117,1389950,0,0,0,0,0,0,11842937021,1391696,0,0,0,0,0,0
94.111,23749017858,11904275144,11844742714,11902884671,1390473,0,0,0,0,0,0,11843350697,1392017,0,0,0,0,0,0
94.321,23843639939,11945914785,11897725154,11944519526,1395259,0,0,0,0,0,0,11896327108,1398046,0,0,0,0,0,0
94.528,23948939838,12004179257,11944760581,12002777369,1401888,0,0,0,0,0,0,11943357096,1403485,0,0,0,0,0,0
94.735,23955271300,12007402628,11947868672,12006000116,1402512,0,0,0,0,0,0,11946464614,1404058,0,0,0,0,0,0
94.958,24038278056,12044531283,11993746773,12043124551,1406732,0,0,0,0,0,0,11992337481,1409292,0,0,0,0,0,0
95.171,24154381598,12107088584,12047293014,12105674686,1413898,0,0,0,0,0,0,12045877504,1415510,0,0,0,0,0,0
95.377,24161530886,12110530400,12051000486,12109115841,1414559,0,0,0,0,0,0,12049584315,1416171,0,0,0,0,0,0
95.611,24228900720,12144219346,12084681374,12142800981,1418365,0,0,0,0,0,0,12083261397,1419977,0,0,0,0,0,0
95.821,24349997003,12205850431,12144146572,12204424946,1425485,0,0,0,0,0,0,12142719711,1426861,0,0,0,0,0,0
96.027,24367792720,12213659815,12154132905,12212233173,1426642,0,0,0,0,0,0,12152704597,1428308,0,0,0,0,0,0
96.237,24398796195,12225568908,12173227287,12224140869,1428039,0,0,0,0,0,0,12171796813,1430474,0,0,0,0,0,0
96.445,24509115596,12263068590,12246047006,12261636202,1432388,0,0,0,0,0,0,12244608251,1438755,0,0,0,0,0,0
96.652,24573942420,12316731838,12257210582,12315293307,1438531,0,0,0,0,0,0,12255770305,1440277,0,0,0,0,0,0
96.859,24574054710,12316789468,12257265242,12315350751,1438717,0,0,0,0,0,0,12255824804,1440438,0,0,0,0,0,0
97.069,24683864680,12365655731,12318208949,12364211315,1444416,0,0,0,0,0,0,12316761511,1447438,0,0,0,0,0,0
97.276,24779604998,12419605014,12359999984,12418154393,1450621,0,0,0,0,0,0,12358547585,1452399,0,0,0,0,0,0
97.483,24780318731,12419919638,12360399093,12418468833,1450805,0,0,0,0,0,0,12358946514,1452579,0,0,0,0,0,0
97.693,24881565599,12463678818,12417886781,12462223006,1455812,0,0,0,0,0,0,12416427675,1459106,0,0,0,0,0,0
97.902,24981328457,12520094193,12461234264,12518631920,1462273,0,0,0,0,0,0,12459770143,1464121,0,0,0,0,0,0
98.109,24986574328,12523047658,12463526670,12521584781,1462877,0,0,0,0,0,0,12462062032,1464638,0,0,0,0,0,0
98.317,25046989623,12552967288,12494022335,12551501024,1466264,0,0,0,0,0,0,12492554217,1468118,0,0,0,0,0,0
98.526,25123860218,12587324438,12536535780,12585854197,1470241,0,0,0,0,0,0,12535062743,1473037,0,0,0,0,0,0
98.734,25192839301,12626176660,12566662641,12624701702,1474958,0,0,0,0,0,0,12565185826,1476815,0,0,0,0,0,0
98.943,25226399283,12644168192,12582231091,12642691214,1476978,0,0,0,0,0,0,12580752446,1478645,0,0,0,0,0,0
99.162,25308796821,12679904708,12628892113,12678423601,1481107,0,0,0,0,0,0,12627408146,1483967,0,0,0,0,0,0
99.374,25385637203,12715892249,12669744954,12714406863,1485386,0,0,0,0,0,0,12668256187,1488767,0,0,0,0,0,0
99.581,25399106879,12729306267,12669800612,12727819213,1487054,0,0,0,0,0,0,12668311672,1488940,0,0,0,0,0,0
99.792,25498983574,12769309154,12729674420,12767817406,1491748,0,0,0,0,0,0,12728178614,1495806,0,0,0,0,0,0
100.000,25600474270,12829304515,12771169755,12827805955,1498560,0,0,0,0,0,0,12769669125,1500630,0,0,0,0,0,0
100.207,25605363041,12832435518,12772927523,12830936374,1499144,0,0,0,0,0,0,12771426516,1501007,0,0,0,0,0,0
100.416,25685086341,12856797215,12828289126,12855295206,1502009,0,0,0,0,0,0,12826781884,1507242,0,0,0,0,0,0
100.624,25787819951,12919091584,12868728367,12917582503,1509081,0,0,0,0,0,0,12867216354,1512013,0,0,0,0,0,0
100.831,25811615243,12935558024,12876057219,12934046900,1511124,0,0,0,0,0,0,12874544131,1513088,0,0,0,0,0,0
101.051,25880542147,12960985744,12919556403,12959471701,1514043,0,0,0,0,0,0,12918038417,1517986,0,0,0,0,0,0
101.271,25995448176,13019975121,12975473055,13018454342,1520779,0,0,0,0,0,0,12973948635,1524420,0,0,0,0,0,0
101.479,26017857295,13038675891,12979181404,13037152846,1523045,0,0,0,0,0,0,12977656322,1525082,0,0,0,0,0,0
101.693,26056679170,13059335991,12997343179,13057810612,1525379,0,0,0,0,0,0,12995816018,1527161,0,0,0,0,0,0
101.902,26143016238,13088685573,13054330665,13087156737,1528836,0,0,0,0,0,0,13052796957,1533708,0,0,0,0,0,0
102.110,26224003978,13141745185,13082258793,13140210288,1534897,0,0,0,0,0,0,13080721746,1537047,0,0,0,0,0,0
102.318,26224111695,13141797107,13082314588,13140262088,1535019,0,0,0,0,0,0,13080777361,1537227,0,0,0,0,0,0
102.525,26332843775,13190656023,13142187752,13189115376,1540647,0,0,0,0,0,0,13140643673,1544079,0,0,0,0,0,0
102.737,26427141496,13242108727,13185032769,13240562136,1546591,0,0,0,0,0,0,13183483728,1549041,0,0,0,0,0,0
102.944,26430371301,13244925928,13185445373,13243378845,1547083,0,0,0,0,0,0,13183896046,1549327,0,0,0,0,0,0
103.151,26492115215,13280405298,13211709917,13278854209,1551089,0,0,0,0,0,0,13210157535,1552382,0,0,0,0,0,0
103.375,26599704344,13331943257,13267761087,13330386221,1557036,0,0,0,0,0,0,13266202293,1558794,0,0,0,0,0,0
103.582,26636693418,13348052257,13288641161,13346493142,1559115,0,0,0,0,0,0,13287079819,1561342,0,0,0,0,0,0
103.794,26724216896,13383693050,13340523846,13382129841,1563209,0,0,0,0,0,0,13338956589,1567257,0,0,0,0,0,0
104.007,26833021695,13444952730,13388068965,13443382466,1570264,0,0,0,0,0,0,13386496146,1572819,0,0,0,0,0,0
104.213,26842961105,13451183619,13391777486,13449612399,1571220,0,0,0,0,0,0,13390203964,1573522,0,0,0,0,0,0
104.425,26889637173,13473431397,13416205776,13471857643,1573754,0,0,0,0,0,0,13414629448,1576328,0,0,0,0,0,0
104.654,27004317218,13513920815,13490396403,13512342349,1578466,0,0,0,0,0,0,13488811641,1584762,0,0,0,0,0,0
104.865,27049335571,13554430583,13494904988,13552847378,1583205,0,0,0,0,0,0,13493319407,1585581,0,0,0,0,0,0
105.075,27052225768,13554876933,13497348835,13553293674,1583259,0,0,0,0,0,0,13495762977,1585858,0,0,0,0,0,0
105.284,27156060938,13595295116,13560765822,13593707139,1587977,0,0,0,0,0,0,13559172653,1593169,0,0,0,0,0,0
105.494,27255298927,13657352185,13597946742,13655757108,1595077,0,0,0,0,0,0,13596349151,1597591,0,0,0,0,0,0
105.702,27255620112,13657559459,13598060653,13655964162,1595297,0,0,0,0,0,0,13596462878,1597775,0,0,0,0,0,0
105.912,27361375532,13703440109,13657935423,13701839536,1600573,0,0,0,0,0,0,13656330770,1604653,0,0,0,0,0,0
106.119,27456167184,13757799700,13698367484,13756192930,1606770,0,0,0,0,0,0,13696758172,1609312,0,0,0,0,0,0
106.326,27461877641,13760684671,13701192970,13759077335,1607336,0,0,0,0,0,0,13699583076,1609894,0,0,0,0,0,0
106.535,27569457674,13803383155,13766074519,13801770924,1612231,0,0,0,0,0,0,13764457299,1617220,0,0,0,0,0,0
106.745,27662662387,13860438192,13802224195,13858819494,1618698,0,0,0,0,0,0,13800602716,1621479,0,0,0,0,0,0
106.951,27668121831,13863804837,13804316994,13862185559,1619278,0,0,0,0,0,0,13802695085,1621909,0,0,0,0,0,0
107.173,27747850695,13892674968,13855175727,13891052385,1622583,0,0,0,0,0,0,13853548078,1627649,0,0,0,0,0,0
107.391,27867893234,13963558330,13904334904,13961927637,1630693,0,0,0,0,0,0,13902701560,1633344,0,0,0,0,0,0
107.597,27874380230,13966935944,13907444286,13965304552,1631392,0,0,0,0,0,0,13905810308,1633978,0,0,0,0,0,0
107.808,27926067990,13988111549,13937956441,13986477740,1633809,0,0,0,0,0,0,13936318993,1637448,0,0,0,0,0,0
108.027,28031565444,14025183016,14006382428,14023544838,1638178,0,0,0,0,0,0,14004737170,1645258,0,0,0,0,0,0
108.234,28080678938,14070058106,14010620832,14068414742,1643364,0,0,0,0,0,0,14008974863,1645969,0,0,0,0,0,0
108.448,28102159152,14083259167,14018899985,14081614308,1644859,0,0,0,0,0,0,14017253026,1646959,0,0,0,0,0,0
108.657,28201911865,14120064620,14081847245,14118415457,1649163,0,0,0,0,0,0,14080193106,1654139,0,0,0,0,0,0
108.870,28286740027,14173049998,14113690029,14171394804,1655194,0,0,0,0,0,0,14112032151,1657878,0,0,0,0,0,0
109.077,28286928026,14173180584,14113747442,14171525241,1655343,0,0,0,0,0,0,14112089420,1658022,0,0,0,0,0,0
109.284,28353185107,14213166410,14140018697,14211506510,1659900,0,0,0,0,0,0,14138357553,1661144,0,0,0,0,0,0
109.494,28453481646,14257666509,14195815137,14256001441,1665068,0,0,0,0,0,0,14194147569,1667568,0,0,0,0,0,0
109.701,28493188160,14276309086,14216879074,14274641676,1667410,0,0,0,0,0,0,14215208936,1670138,0,0,0,0,0,0
109.909,28583062964,14310751011,14272311953,14309079543,1671468,0,0,0,0,0,0,14270635482,1676471,0,0,0,0,0,0
110.117,28693066417,14375952944,14317113473,14374274044,1678900,0,0,0,0,0,0,14315431749,1681724,0,0,0,0,0,0
110.324,28699516385,14379440622,14320075763,14377761084,1679538,0,0,0,0,0,0,14318393463,1682300,0,0,0,0,0,0
110.533,28789369859,14416575813,14372794046,14414892018,1683795,0,0,0,0,0,0,14371105764,1688282,0,0,0,0,0,0
110.764,28899706019,14479611333,14420094686,14477920321,1691012,0,0,0,0,0,0,14418400922,1693764,0,0,0,0,0,0
110.971,28905776690,14482569019,14423207671,14480877426,1691593,0,0,0,0,0,0,14421513261,1694410,0,0,0,0,0,0
111.201,28989631589,14519028643,14470602946,14517332846,1695797,0,0,0,0,0,0,14468903175,1699771,0,0,0,0,0,0
111.425,29105416247,14582192411,14523223836,14580489380,1703031,0,0,0,0,0,0,14521517968,1705868,0,0,0,0,0,0
111.632,29112037463,14585699261,14526338202,14583995561,1703700,0,0,0,0,0,0,14524631700,1706502,0,0,0,0,0,0
111.856,29166816430,14607447023,14559369407,14605740852,1706171,0,0,0,0,0,0,14557659124,1710283,0,0,0,0,0,0
112.076,29283292823,14658329789,14624963034,14656617706,1712083,0,0,0,0,0,0,14623245199,1717835,0,0,0,0,0,0
112.284,29318289173,14688819502,14629469671,14687103837,1715665,0,0,0,0,0,0,14627751061,1718610,0,0,0,0,0,0
112.494,29332680602,14695145607,14637534995,14693429230,1716377,0,0,0,0,0,0,14635815478,1719517,0,0,0,0,0,0
112.704,29452775887,14742195911,14710579976,14740474031,1721880,0,0,0,0,0,0,14708852130,1727846,0,0,0,0,0,0
112.913,29521457281,14788928144,14732529137,14787200941,1727203,0,0,0,0,0,0,14730798688,1730449,0,0,0,0,0,0
113.120,29524601680,14792007285,14732594395,14790279587,1727698,0,0,0,0,0,0,14730863785,1730610,0,0,0,0,0,0
113.328,29636986637,14840272386,14796714251,14838539148,1733238,0,0,0,0,0,0,14794976199,1738052,0,0,0,0,0,0
113.538,29728506270,14894192252,14834314018,14892452831,1739421,0,0,0,0,0,0,14832571521,1742497,0,0,0,0,0,0
113.745,29730870871,14895132489,14835738382,14893392752,1739737,0,0,0,0,0,0,14833995482,1742900,0,0,0,0,0,0
113.952,29798753405,14936756595,14861996810,14935012145,1744450,0,0,0,0,0,0,14860250891,1745919,0,0,0,0,0,0
114.163,29873330386,14969090098,14904240288,14967341915,1748183,0,0,0,0,0,0,14902489508,1750780,0,0,0,0,0,0
114.370,29937110860,14998249535,14938861325,14996497888,1751647,0,0,0,0,0,0,14937106428,1754897,0,0,0,0,0,0
114.595,30009932341,15031930350,14978001991,15030174866,1755484,0,0,0,0,0,0,14976242664,1759327,0,0,0,0,0,0
114.813,30135493872,15097938052,15037555820,15096174989,1763063,0,0,0,0,0,0,15035789521,1766299,0,0,0,0,0,0
115.020,30143445896,15101383200,15042062696,15099619429,1763771,0,0,0,0,0,0,15040295576,1767120,0,0,0,0,0,0
115.239,30195131775,15122574901,15072556874,15120808702,1766199,0,0,0,0,0,0,15070786276,1770598,0,0,0,0,0,0
115.455,30297274345,15163973560,15133300785,15162202555,1771005,0,0,0,0,0,0,15131523207,1777578,0,0,0,0,0,0
115.663,30349699376,15204507776,15145191600,15202731998,1775778,0,0,0,0,0,0,15143412403,1779197,0,0,0,0,0,0
115.873,30367088203,15211919770,15155168433,15210143135,1776635,0,0,0,0,0,0,15153388122,1780311,0,0,0,0,0,0
116.081,30476027474,15253922293,15222105181,15252140719,1781574,0,0,0,0,0,0,15220317233,1787948,0,0,0,0,0,0
116.288,30553037400,15304823540,15248213860,15303036153,1787387,0,0,0,0,0,0,15246422817,1791043,0,0,0,0,0,0
116.496,30555957194,15307638338,15248318856,15305850472,1787866,0,0,0,0,0,0,15246527625,1791231,0,0,0,0,0,0
116.703,30630470649,15355881356,15274589293,15354088056,1793300,0,0,0,0,0,0,15272794993,1794300,0,0,0,0,0,0
116.913,30712809004,15384051578,15328757426,15382254880,1796698,0,0,0,0,0,0,15326956909,1800517,0,0,0,0,0,0
117.120,30762206650,15410761745,15351444905,15408961864,1799881,0,0,0,0,0,0,15349641650,1803255,0,0,0,0,0,0
117.331,30852326897,15448958162,15403368735,15447153889,1804273,0,0,0,0,0,0,15401559581,1809154,0,0,0,0,0,0
117.549,30962247958,15510780252,15451467706,15508968951,1811301,0,0,0,0,0,0,15449652957,1814749,0,0,0,0,0,0
117.756,30968457822,15513885359,15454572463,15512073472,1811887,0,0,0,0,0,0,15452757161,1815302,0,0,0,0,0,0
117.967,31028394798,15540154869,15488239929,15538339935,1814934,0,0,0,0,0,0,15486420814,1819115,0,0,0,0,0,0
118.180,31113808214,15582344235,15531463979,15580524460,1819775,0,0,0,0,0,0,15529639907,1824072,0,0,0,0,0,0
118.387,31174619196,15616960105,15557659091,15615136286,1823819,0,0,0,0,0,0,15555831812,1827279,0,0,0,0,0,0
118.594,31174727005,15617012556,15557714449,15615188613,1823943,0,0,0,0,0,0,15555887000,1827449,0,0,0,0,0,0
118.801,31287696955,15665865000,15621831955,15664035422,1829578,0,0,0,0,0,0,15619997153,1834802,0,0,0,0,0,0
119.009,31379964444,15719803805,15660160639,15717968038,1835767,0,0,0,0,0,0,15658321331,1839308,0,0,0,0,0,0
119.217,31380984888,15720138320,15660846568,15718302342,1835978,0,0,0,0,0,0,15659007001,1839567,0,0,0,0,0,0
119.426,31494915270,15763896707,15731018563,15762055735,1840972,0,0,0,0,0,0,15729171078,1847485,0,0,0,0,0,0
119.633,31582108902,15820310134,15761798768,15818462743,1847391,0,0,0,0,0,0,15759947621,1851147,0,0,0,0,0,0
119.840,31587226900,15823256464,15763970436,15821408562,1847902,0,0,0,0,0,0,15762118870,1851566,0,0,0,0,0,0
120.055,31676284566,15861450691,15814833875,15859598418,1852273,0,0,0,0,0,0,15812976529,1857346,0,0,0,0,0,0
120.266,31776788508,15912799215,15863989293,15910940998,1858217,0,0,0,0,0,0,15862126251,1863042,0,0,0,0,0,0
120.473,31793481958,15926381429,15867100529,15924521509,1859920,0,0,0,0,0,0,15865236880,1863649,0,0,0,0,0,0
120.695,31847631800,15951324569,15896307231,15949461797,1862772,0,0,0,0,0,0,15894440297,1866934,0,0,0,0,0,0
120.911,31945119608,15993631574,15951488034,15991763885,1867689,0,0,0,0,0,0,15949614762,1873272,0,0,0,0,0,0
121.118,31999733047,16029508457,15970224590,16027636495,1871962,0,0,0,0,0,0,15968348932,1875658,0,0,0,0,0,0
121.355,32049751144,16053263288,15996487856,16051388612,1874676,0,0,0,0,0,0,15994609232,1878624,0,0,0,0,0,0
121.576,32124139336,16093239679,16030899657,16091360485,1879194,0,0,0,0,0,0,16029017055,1882602,0,0,0,0,0,0
121.785,32205992658,16132635938,16073356720,16130751940,1883998,0,0,0,0,0,0,16071468942,1887778,0,0,0,0,0,0
121.995,32214484416,16137826433,16076657983,16135941839,1884594,0,0,0,0,0,0,16074769818,1888165,0,0,0,0,0,0
122.202,32327514660,16182043390,16145471270,16180153563,1889827,0,0,0,0,0,0,16143575260,1896010,0,0,0,0,0,0
122.410,32412157308,16235646604,16176510704,16233750641,1895963,0,0,0,0,0,0,16174610980,1899724,0,0,0,0,0,0
122.618,32412397112,16235771292,16176625820,16233875145,1896147,0,0,0,0,0,0,16174725893,1899927,0,0,0,0,0,0
122.825,32516109202,16279603245,16236505957,16277702063,1901182,0,0,0,0,0,0,16234599210,1906747,0,0,0,0,0,0
123.033,32612618532,16335744592,16276873940,16333837031,1907561,0,0,0,0,0,0,16274962498,1911442,0,0,0,0,0,0
123.241,32618657996,16338894645,16279763351,16336986522,1908123,0,0,0,0,0,0,16277851363,1911988,0,0,0,0,0,0
123.453,32707449490,16372264462,16335185028,16370352444,1912018,0,0,0,0,0,0,16333266744,1918284,0,0,0,0,0,0
123.662,32819058957,16439068714,16379990243,16437149065,1919649,0,0,0,0,0,0,16378066721,1923522,0,0,0,0,0,0
123.869,32824978441,16442026986,16382951455,16440106740,1920246,0,0,0,0,0,0,16381027358,1924097,0,0,0,0,0,0
124.088,32903604372,16479160151,16424444221,16477235642,1924509,0,0,0,0,0,0,16422515416,1928805,0,0,0,0,0,0
124.310,33024759456,16541784099,16482975357,16539852411,1931688,0,0,0,0,0,0,16481039744,1935613,0,0,0,0,0,0
124.517,33031235520,16545151784,16486083736,16543219517,1932267,0,0,0,0,0,0,16484147549,1936187,0,0,0,0,0,0
124.745,33096402903,16576682051,16519720852,16574746163,1935888,0,0,0,0,0,0,16517780834,1940018,0,0,0,0,0,0
124.961,33211574995,16625886960,16585688035,16623945355,1941605,0,0,0,0,0,0,16583740413,1947622,0,0,0,0,0,0
125.169,33237619743,16648283741,16589336002,16646339362,1944379,0,0,0,0,0,0,16587387651,1948351,0,0,0,0,0,0
125.386,33269492949,16656766793,16612726156,16654821421,1945372,0,0,0,0,0,0,16610775169,1950987,0,0,0,0,0,0
125.607,33385260969,16701893684,16683367285,16699943063,1950621,0,0,0,0,0,0,16681408162,1959123,0,0,0,0,0,0
125.821,33443900850,16751405420,16692495430,16749449064,1956356,0,0,0,0,0,0,16690534950,1960480,0,0,0,0,0,0
126.032,33453291029,16759874650,16693416379,16757917340,1957310,0,0,0,0,0,0,16691455778,1960601,0,0,0,0,0,0
126.241,33560350023,16792552936,16767797087,16790591710,1961226,0,0,0,0,0,0,16765828013,1969074,0,0,0,0,0,0
126.448,33647084242,16851578782,16795505460,16849610836,1967946,0,0,0,0,0,0,16793533047,1972413,0,0,0,0,0,0
126.656,33650284384,16854658813,16795625571,16852690382,1968431,0,0,0,0,0,0,16793653008,1972563,0,0,0,0,0,0
126.866,33753662106,16900543600,16853118506,16898569831,1973769,0,0,0,0,0,0,16851139397,1979109,0,0,0,0,0,0
127.074,33851367427,16955502335,16895865092,16953522302,1980033,0,0,0,0,0,0,16893881038,1984054,0,0,0,0,0,0
127.281,33856533153,16957785177,16898747976,16955804690,1980487,0,0,0,0,0,0,16896763418,1984558,0,0,0,0,0,0
127.493,33947123483,16991151457,16955972026,16989167117,1984340,0,0,0,0,0,0,16953980907,1991119,0,0,0,0,0,0
127.709,34056587087,17057810618,16998776469,17055818667,1991951,0,0,0,0,0,0,16996780334,1996135,0,0,0,0,0,0
127.916,34062791391,17060909590,17001881801,17058917106,1992484,0,0,0,0,0,0,16999885101,1996700,0,0,0,0,0,0
128.124,34126963320,17094589449,17032373871,17092593136,1996313,0,0,0,0,0,0,17030373722,2000149,0,0,0,0,0,0
128.341,34208041132,17129280299,17078760833,17127279966,2000333,0,0,0,0,0,0,17076755401,2005432,0,0,0,0,0,0
128.549,34269048003,17164040309,17105007694,17162035718,2004591,0,0,0,0,0,0,17102998952,2008742,0,0,0,0,0,0
128.758,34281554652,17168280639,17113274013,17166275550,2005089,0,0,0,0,0,0,17111264347,2009666,0,0,0,0,0,0
128.966,34392160688,17213436606,17178724082,17211426224,2010382,0,0,0,0,0,0,17176706901,2017181,0,0,0,0,0,0
129.173,34472121989,17264089374,17208032615,17262073202,2016172,0,0,0,0,0,0,17206011971,2020644,0,0,0,0,0,0
129.379,34475299097,17267164592,17208134505,17265147985,2016607,0,0,0,0,0,0,17206113706,2020799,0,0,0,0,0,0
129.587,34579405233,17307157987,17272247246,17305136705,2021282,0,0,0,0,0,0,17270219096,2028150,0,0,0,0,0,0
129.795,34676204696,17367162591,17309042105,17365134471,2028120,0,0,0,0,0,0,17307009612,2032493,0,0,0,0,0,0
130.002,34681565546,17370294883,17311270663,17368266181,2028702,0,0,0,0,0,0,17309237680,2032983,0,0,0,0,0,0
130.212,34764483432,17401288239,17363195193,17399255978,2032261,0,0,0,0,0,0,17361156310,2038883,0,0,0,0,0,0
130.423,34879300062,17470316948,17408983114,17468276817,2040131,0,0,0,0,0,0,17406938925,2044189,0,0,0,0,0,0
130.632,34887888752,17473419140,17414469612,17471378433,2040707,0,0,0,0,0,0,17412424592,2045020,0,0,0,0,0,0
130.847,34948473987,17502675906,17445798081,17500631888,2044018,0,0,0,0,0,0,17443749506,2048575,0,0,0,0,0,0
131.074,35075883192,17562519464,17513363728,17560468508,2050956,0,0,0,0,0,0,17511307295,2056433,0,0,0,0,0,0
131.280,35094151940,17576546491,17517605449,17574493725,2052766,0,0,0,0,0,0,17515548269,2057180,0,0,0,0,0,0
131.489,35115331639,17582686489,17532645150,17580632999,2053490,0,0,0,0,0,0,17530586279,2058871,0,0,0,0,0,0
131.747,35272878982,17666758019,17606120963,17664694865,2063154,0,0,0,0,0,0,17604053537,2067426,0,0,0,0,0,0
131.953,35300412513,17679675410,17620737103,17677610582,2064828,0,0,0,0,0,0,17618667806,2069297,0,0,0,0,0,0
132.165,35323491001,17694481092,17629009909,17692414594,2066498,0,0,0,0,0,0,17626939654,2070255,0,0,0,0,0,0
132.373,35408384439,17721407740,17686976699,17719338012,2069728,0,0,0,0,0,0,17684899802,2076897,0,0,0,0,0,0
132.581,35506518583,17782747437,17723771146,17780670698,2076739,0,0,0,0,0,0,17721689938,2081208,0,0,0,0,0,0
132.788,35506671939,17782805009,17723866930,17780728094,2076915,0,0,0,0,0,0,17721785542,2081388,0,0,0,0,0,0
132.996,35606536617,17822799293,17783737324,17820717722,2081571,0,0,0,0,0,0,17781649117,2088207,0,0,0,0,0,0
133.204,35708116399,17882541358,17825575041,17880452939,2088419,0,0,0,0,0,0,17823481923,2093118,0,0,0,0,0,0
133.411,35712927093,17885931922,17826995171,17883842937,2088985,0,0,0,0,0,0,17824901714,2093457,0,0,0,0,0,0
133.619,35809932363,17927571124,17882361239,17925477355,2093769,0,0,0,0,0,0,17880261473,2099766,0,0,0,0,0,0
133.828,35913269414,17986105957,17927163457,17984005480,2100477,0,0,0,0,0,0,17925058513,2104944,0,0,0,0,0,0
134.034,35919187592,17989062592,17930125000,17986961510,2101082,0,0,0,0,0,0,17928019450,2105550,0,0,0,0,0,0
134.250,35997166537,18016302347,17980864190,18014198153,2104194,0,0,0,0,0,0,17978752898,2111292,0,0,0,0,0,0
134.471,36115000783,18084857581,18030143202,18082745563,2112018,0,0,0,0,0,0,18028026163,2117039,0,0,0,0,0,0
134.677,36125438162,18092184897,18033253265,18090071828,2113069,0,0,0,0,0,0,18031135635,2117630,0,0,0,0,0,0
134.892,36180119701,18116370975,18063748726,18114255163,2115812,0,0,0,0,0,0,18061627635,2121091,0,0,0,0,0,0
135.103,36281048932,18154786028,18126262904,18152665726,2120302,0,0,0,0,0,0,18124134660,2128244,0,0,0,0,0,0
135.310,36331697686,18195313797,18136383889,18193188665,2125132,0,0,0,0,0,0,18134254171,2129718,0,0,0,0,0,0
135.544,36359557344,18207709724,18151847620,18205583171,2126553,0,0,0,0,0,0,18149716144,2131476,0,0,0,0,0,0
135.762,36490904578,18264447971,18226456607,18262314898,2133073,0,0,0,0,0,0,18224316587,2140020,0,0,0,0,0,0
135.981,36537946580,18298435844,18239510736,18296298747,2137097,0,0,0,0,0,0,18237368976,2141760,0,0,0,0,0,0
136.193,36547896700,18302678095,18245218605,18300540503,2137592,0,0,0,0,0,0,18243076202,2142403,0,0,0,0,0,0
136.401,36648160826,18339313906,18308846920,18337172064,2141842,0,0,0,0,0,0,18306697249,2149671,0,0,0,0,0,0
136.610,36743275378,18400751543,18342523835,18398602723,2148820,0,0,0,0,0,0,18340370190,2153645,0,0,0,0,0,0
136.817,36744192319,18401558893,18342633426,18399409818,2149075,0,0,0,0,0,0,18340479670,2153756,0,0,0,0,0,0
137.025,36844066505,18441560256,18402506249,18439406574,2153682,0,0,0,0,0,0,18400345646,2160603,0,0,0,0,0,0
137.232,36944758818,18501816178,18442942640,18499655653,2160525,0,0,0,0,0,0,18440777311,2165329,0,0,0,0,0,0
137.440,36950446949,18504681466,18445765483,18502520406,2161060,0,0,0,0,0,0,18443599592,2165891,0,0,0,0,0,0
137.651,37039196608,18538053034,18501143574,18535888177,2164857,0,0,0,0,0,0,18498971371,2172203,0,0,0,0,0,0
137.859,37150243790,18604312636,18545931154,18602140272,2172364,0,0,0,0,0,0,18543753779,2177375,0,0,0,0,0,0
138.066,37156703857,18607805670,18548898187,18605632613,2173057,0,0,0,0,0,0,18546720169,2178018,0,0,0,0,0,0
138.278,37220654511,18633225921,18587428590,18631049934,2175987,0,0,0,0,0,0,18585246235,2182355,0,0,0,0,0,0
138.490,37313637552,18665854705,18647782847,18663674864,2179841,0,0,0,0,0,0,18645593584,2189263,0,0,0,0,0,0
138.698,37363284924,18711257384,18652027540,18709072249,2185135,0,0,0,0,0,0,18649837435,2190105,0,0,0,0,0,0
138.909,37391869018,18729249477,18662619541,18727062314,2187163,0,0,0,0,0,0,18660428224,2191317,0,0,0,0,0,0
139.117,37486663024,18753004805,18733658219,18750814736,2190069,0,0,0,0,0,0,18731458821,2199398,0,0,0,0,0,0
139.324,37569334247,18814184188,18755150059,18811987114,2197074,0,0,0,0,0,0,18752948079,2201980,0,0,0,0,0,0
139.533,37569645564,18814386441,18755259123,18812189236,2197205,0,0,0,0,0,0,18753057005,2202118,0,0,0,0,0,0
139.741,37675421314,18854984398,18820436916,18852782493,2201905,0,0,0,0,0,0,18818227364,2209552,0,0,0,0,0,0
139.948,37772009094,18914648663,18857360431,18912439956,2208707,0,0,0,0,0,0,18855146568,2213863,0,0,0,0,0,0
140.155,37775897453,18917513517,18858383936,18915304275,2209242,0,0,0,0,0,0,18856169791,2214145,0,0,0,0,0,0
140.363,37849684617,18960215827,18889468790,18958001680,2214147,0,0,0,0,0,0,18887251061,2217729,0,0,0,0,0,0
140.578,37934351385,18991370823,18942980562,18989152966,2217857,0,0,0,0,0,0,18940756716,2223846,0,0,0,0,0,0
140.784,37982725087,19020641588,18962083499,19018420276,2221312,0,0,0,0,0,0,18959857304,2226195,0,0,0,0,0,0
140.998,38057529647,19055400540,19002129107,19053175260,2225280,0,0,0,0,0,0,18999898313,2230794,0,0,0,0,0,0
141.210,38153733063,19099709909,19054023154,19097479577,2230332,0,0,0,0,0,0,19051786413,2236741,0,0,0,0,0,0
141.416,38188985874,19123772440,19065213434,19121539160,2233280,0,0,0,0,0,0,19062975156,2238278,0,0,0,0,0,0
141.637,38222052947,19139087455,19082965492,19136852451,2235004,0,0,0,0,0,0,19080725208,2240284,0,0,0,0,0,0
141.862,38354179498,19196179487,19158000011,19193937870,2241617,0,0,0,0,0,0,19155751135,2248876,0,0,0,0,0,0
142.070,38395233992,19226894678,19168339314,19224649423,2245255,0,0,0,0,0,0,19166088989,2250325,0,0,0,0,0,0
142.277,38400359802,19231136250,19169223552,19228890506,2245744,0,0,0,0,0,0,19166973119,2250433,0,0,0,0,0,0
142.486,38504990337,19267776920,19237213417,19265526833,2250087,0,0,0,0,0,0,19234955193,2258224,0,0,0,0,0,0
142.694,38601034648,19329819536,19271215112,19327562353,2257183,0,0,0,0,0,0,19268952762,2262350,0,0,0,0,0,0
142.901,38601498781,19330023681,19271475100,19327766358,2257323,0,0,0,0,0,0,19269212594,2262506,0,0,0,0,0,0
143.110,38721004328,19378281981,19342722347,19376019043,2262938,0,0,0,0,0,0,19340451665,2270682,0,0,0,0,0,0
143.318,38803990721,19430011876,19373978845,19427743000,2268876,0,0,0,0,0,0,19371704510,2274335,0,0,0,0,0,0
143.526,38807768345,19433159661,19374608684,19430890169,2269492,0,0,0,0,0,0,19372334028,2274656,0,0,0,0,0,0
143.734,38863958647,19463087499,19400871148,19460814609,2272890,0,0,0,0,0,0,19398593473,2277675,0,0,0,0,0,0
143.943,38950339927,19497435020,19452904907,19495158184,2276836,0,0,0,0,0,0,19450621310,2283597,0,0,0,0,0,0
144.149,39014015492,19536278436,19477737056,19533996996,2281440,0,0,0,0,0,0,19475450336,2286720,0,0,0,0,0,0
144.361,39025651366,19544756644,19480894722,19542474239,2282405,0,0,0,0,0,0,19478607622,2287100,0,0,0,0,0,0
144.568,39129384822,19585674980,19543709842,19583387850,2287130,0,0,0,0,0,0,19541415519,2294323,0,0,0,0,0,0
144.776,39219806135,19639197698,19580608437,19636904406,2293292,0,0,0,0,0,0,19578309769,2298668,0,0,0,0,0,0
144.982,39220279947,19639405818,19580874129,19637112336,2293482,0,0,0,0,0,0,19578575232,2298897,0,0,0,0,0,0
145.190,39314843562,19674894671,19639948891,19672597075,2297596,0,0,0,0,0,0,19637643222,2305669,0,0,0,0,0,0
145.397,39420226607,19739112900,19681113707,19736808045,2304855,0,0,0,0,0,0,19678803239,2310468,0,0,0,0,0,0
145.604,39426533629,19742528560,19684005069,19740223102,2305458,0,0,0,0,0,0,19681694059,2311010,0,0,0,0,0,0
145.815,39521952206,19781781718,19740170488,19779471800,2309918,0,0,0,0,0,0,19737853092,2317396,0,0,0,0,0,0
146.027,39626911292,19842285289,19784626003,19839968420,2316869,0,0,0,0,0,0,19782303352,2322651,0,0,0,0,0,0
146.234,39632799122,19845657138,19787141984,19843339626,2317512,0,0,0,0,0,0,19784818790,2323194,0,0,0,0,0,0
146.447,39698053420,19880409077,19817644343,19878087629,2321448,0,0,0,0,0,0,19815317646,2326697,0,0,0,0,0,0
146.664,39775640989,19918992142,19856648847,19916666254,2325888,0,0,0,0,0,0,19854317625,2331222,0,0,0,0,0,0
146.871,39839058808,19948780287,19890278521,19946450773,2329514,0,0,0,0,0,0,19887943195,2335326,0,0,0,0,0,0
147.092,39875105238,19962389274,19912715964,19960058200,2331074,0,0,0,0,0,0,19910378112,2337852,0,0,0,0,0,0
147.301,39978475096,19999904306,19978570790,19997568859,2335447,0,0,0,0,0,0,19976225391,2345399,0,0,0,0,0,0
147.507,40045162535,20051849653,19993312882,20049508275,2341378,0,0,0,0,0,0,19990965652,2347230,0,0,0,0,0,0
147.714,40045311759,20051906899,19993404860,20049565351,2341548,0,0,0,0,0,0,19991057488,2347372,0,0,0,0,0,0
147.922,40158283192,20100767696,20057515496,20098420541,2347155,0,0,0,0,0,0,20055160819,2354677,0,0,0,0,0,0
148.129,40247797833,20151893399,20095904434,20149540350,2353049,0,0,0,0,0,0,20093545304,2359130,0,0,0,0,0,0
148.335,40251563615,20155033957,20096529658,20152680363,2353594,0,0,0,0,0,0,20094170277,2359381,0,0,0,0,0,0
148.544,40350410172,20196659411,20153750761,20194301088,2358323,0,0,0,0,0,0,20151384868,2365893,0,0,0,0,0,0
148.755,40452350862,20255203506,20197147356,20252838471,2365035,0,0,0,0,0,0,20194776422,2370934,0,0,0,0,0,0
148.961,40457815577,20258160122,20199655455,20255794484,2365638,0,0,0,0,0,0,20197284028,2371427,0,0,0,0,0,0
149.185,40539141493,20292903577,20246237916,20290533978,2369599,0,0,0,0,0,0,20243861138,2376778,0,0,0,0,0,0
149.396,40649938568,20350524823,20299413745,20348148605,2376218,0,0,0,0,0,0,20297030781,2382964,0,0,0,0,0,0
149.602,40664080089,20361287153,20302792936,20358909460,2377693,0,0,0,0,0,0,20300409301,2383635,0,0,0,0,0,0
149.813,40699243499,20378642215,20320601284,20376262534,2379681,0,0,0,0,0,0,20318215611,2385673,0,0,0,0,0,0
150.024,40784012789,20425023885,20358988904,20422638946,2384939,0,0,0,0,0,0,20356598775,2390129,0,0,0,0,0,0
150.238,40869941933,20464075777,20405866156,20461686236,2389541,0,0,0,0,0,0,20403470589,2395567,0,0,0,0,0,0
150.446,40870339629,20464415940,20405923689,20462026175,2389765,0,0,0,0,0,0,20403527936,2395753,0,0,0,0,0,0
150.653,40954654251,20488778433,20465875818,20486385791,2392642,0,0,0,0,0,0,20463473333,2402485,0,0,0,0,0,0
150.861,41047378133,20553576756,20493801377,20551176766,2399990,0,0,0,0,0,0,20491395564,2405813,0,0,0,0,0,0
151.067,41076662875,20567534255,20509128620,20565132563,2401692,0,0,0,0,0,0,20506720864,2407756,0,0,0,0,0,0
151.276,41168907764,20606795329,20562112435,20604389069,2406260,0,0,0,0,0,0,20559698656,2413779,0,0,0,0,0,0
151.484,41274926119,20667440524,20607485595,20665027361,2413163,0,0,0,0,0,0,20605066548,2419047,0,0,0,0,0,0
151.691,41282921831,20670662180,20612259651,20668248409,2413771,0,0,0,0,0,0,20609839802,2419849,0,0,0,0,0,0
151.907,41347870632,20696092205,20651778427,20693675464,2416741,0,0,0,0,0,0,20649354135,2424292,0,0,0,0,0,0
152.146,41481150240,20768875882,20712274358,20766450771,2425111,0,0,0,0,0,0,20709843059,2431299,0,0,0,0,0,0
152.353,41489199085,20773802900,20715396185,20771376886,2426014,0,0,0,0,0,0,20712964159,2432026,0,0,0,0,0,0
152.570,41539301769,20793410727,20745891042,20790982455,2428272,0,0,0,0,0,0,20743455562,2435480,0,0,0,0,0,0
152.786,41632616762,20831784004,20800832758,20829351210,2432794,0,0,0,0,0,0,20798390945,2441813,0,0,0,0,0,0
152.994,41695458928,20876930044,20818528884,20874491970,2438074,0,0,0,0,0,0,20816084829,2444055,0,0,0,0,0,0
153.202,41699700299,20881170544,20818529755,20878731997,2438547,0,0,0,0,0,0,20816085687,2444068,0,0,0,0,0,0
153.411,41817559082,20926063109,20891495973,20923619264,2443845,0,0,0,0,0,0,20889043618,2452355,0,0,0,0,0,0
153.618,41897779071,20976184165,20921594906,20973734585,2449580,0,0,0,0,0,0,20919138999,2455907,0,0,0,0,0,0
153.826,41901778844,20980058209,20921720635,20977608073,2450136,0,0,0,0,0,0,20919264492,2456143,0,0,0,0,0,0
154.035,41994085237,21015556853,20978528384,21013102574,2454279,0,0,0,0,0,0,20976065782,2462602,0,0,0,0,0,0
154.243,42101123524,21079171801,21021951723,21076710305,2461496,0,0,0,0,0,0,21019484108,2467615,0,0,0,0,0,0
154.451,42108029347,21083183878,21024845469,21080721719,2462159,0,0,0,0,0,0,21022377305,2468164,0,0,0,0,0,0
154.662,42188819747,21113106626,21075713121,21110641034,2465592,0,0,0,0,0,0,21073239173,2473948,0,0,0,0,0,0
154.874,42294037148,21169172256,21124864892,21166700232,2472024,0,0,0,0,0,0,21122385265,2479627,0,0,0,0,0,0
155.081,42314283861,21186311324,21127972537,21183837120,2474204,0,0,0,0,0,0,21125492321,2480216,0,0,0,0,0,0
155.295,42368910716,21206217921,21162692795,21203741421,2476500,0,0,0,0,0,0,21160208653,2484142,0,0,0,0,0,0
155.502,42462369867,21238160106,21224209761,21235679808,2480298,0,0,0,0,0,0,21221718525,2491236,0,0,0,0,0,0
155.709,42520543777,21289440692,21231103085,21286954400,2486292,0,0,0,0,0,0,21228610765,2492320,0,0,0,0,0,0
155.918,42524786556,21293681405,21231105151,21291194637,2486768,0,0,0,0,0,0,21228612801,2492350,0,0,0,0,0,0
156.130,42626425308,21325043808,21301381500,21322553359,2490449,0,0,0,0,0,0,21298881231,2500269,0,0,0,0,0,0
156.341,42712530020,21378355981,21334174039,21375859357,2496624,0,0,0,0,0,0,21331669827,2504212,0,0,0,0,0,0
156.549,42726866919,21392570119,21334296800,21390071747,2498372,0,0,0,0,0,0,21331792377,2504423,0,0,0,0,0,0
156.756,42818049209,21426265758,21391783451,21423763488,2502270,0,0,0,0,0,0,21389272505,2510946,0,0,0,0,0,0
156.963,42908237121,21484780607,21423456514,21482271689,2508918,0,0,0,0,0,0,21420941836,2514678,0,0,0,0,0,0
157.170,42933122278,21495694848,21437427430,21493184460,2510388,0,0,0,0,0,0,21434910909,2516521,0,0,0,0,0,0
157.386,43022280810,21533889952,21488390858,21531375236,2514716,0,0,0,0,0,0,21485868546,2522312,0,0,0,0,0,0
157.603,43115607998,21578157753,21537450245,21575637923,2519830,0,0,0,0,0,0,21534922204,2528041,0,0,0,0,0,0
157.809,43139375435,21598812876,21540562559,21596290557,2522319,0,0,0,0,0,0,21538033886,2528673,0,0,0,0,0,0
158.023,43184584925,21616825005,21567759920,21614300612,2524393,0,0,0,0,0,0,21565228156,2531764,0,0,0,0,0,0
158.252,43300555906,21661650949,21638904957,21659121337,2529612,0,0,0,0,0,0,21636365022,2539935,0,0,0,0,0,0
158.459,43345639048,21701936908,21643702140,21699402579,2534329,0,0,0,0,0,0,21641161365,2540775,0,0,0,0,0,0
158.666,43357286623,21713583277,21643703346,21711047648,2535629,0,0,0,0,0,0,21641162553,2540793,0,0,0,0,0,0
158.874,43465259477,21751329008,21713930469,21748788951,2540057,0,0,0,0,0,0,21711381684,2548785,0,0,0,0,0,0
159.082,43548702658,21801981191,21746721467,21799435356,2545835,0,0,0,0,0,0,21744168875,2552592,0,0,0,0,0,0
159.288,43551783070,21805008891,21746774179,21802462681,2546210,0,0,0,0,0,0,21744221521,2552658,0,0,0,0,0,0
159.495,43551783070,21805008891,21746774179,21802462681,2546210,0,0,0,0,0,0,21744221521,2552658,0,0,0,0,0,0
